word	definition	
abandon	v./n.放棄；放縱	
abash	v.使害羞，使尷尬	
abate	v.減輕，減少	
abbreviate	v.縮短；縮寫	
abdicate	v.退位，辭職，放棄	
aberrant	a.越軌的；異常的	
aberration	n.離開正路，脫離常軌；變形	
abet	v.教唆，鼓勵，幫助	
abeyance	n.中止，擱置	
abhor	v.憎恨，嫌惡	
abhorrent	a.可恨的，討厭的	
abide	v.容忍，忍受	
abject	a.極可憐的;卑下的	
abjure	v.發誓放棄	
ablution	n.(宗教的)淨禮，沐浴	
abnegate	v.否認，放棄	
abolish	v.廢止，廢除(法律、制度、習俗等)	
abolition	n.廢除，革除	
abominate	v.痛恨；厭惡	
aboveboard	a./adv.光明正大的(地)	
abrade	v.磨損，磨小	
abrasion	n.表面磨損	
abrasive	a.磨損的；生硬粗暴的	
abreast	adv.並列，並排	
abridge	v.刪減；縮短	
abrogate	v.廢止，廢除	
abscission	n.[醫]切除，截去；[植]脫離	
abscond	v.潛逃，逃亡	
absenteeism	n.曠課，曠工	
absolute	a.絕對的，完全的; 無(條件)限制的	
absolve	v.赦免，免除	
absorb	v.吸收；同化；吸引…的注意	
abstain	v.禁絕，放棄	
abstemious	a.有節制的，節儉的	
abstention	n.節制	
abstentious	a.節制的	
abstract	n.摘要；a.抽象的	
abstruse	a.難懂的，深奧的	
absurd	a.荒謬的，可笑的	
abundance	n.充裕，多量	
abundant	a.豐富的，盛產的	
abuse	v./n. 濫用	
abusive	a.譭謗的；虐待的	
abut	v.接界，毗連	
abysmal	a.極深的；糟透的	
academic	a.學院的，學術的；理論的	
academician	n.院士；學會會員	
accede	v.同意	
accelerate	v.加速；促進	
accentuate	v.重讀；強調	
access	n.通路；途徑	
accessible	a.易達到的；易受影響的	
accessory	a.附屬的，次要的	
acclaim	v.歡呼，稱讚	
acclimate	v.使服水土; 使適應	
accolade	n.推崇；讚揚	
accommodate	v.與…一致；提供食宿	
accommodating	a.樂於助人的	
accompany	v.伴隨，陪伴	
accomplice	n.同謀者，幫兇	
accomplish	v.完成，做成功	
accomplished	a.完成了的；有技巧的，有造詣的	
accord	v./n.同意；一致	
accost	v.搭話	
accountability	n.負有責任	
accrete	v.逐漸增長；添加生長；連生	
accretion	n.自然的增加；增加物	
accrue	v.(利息等)增大；增多	
accumulate	v.積聚，積累	
accuracy	n.精確，準確	
accurate	a.精確的，準確的	
accuse	v.譴責，指責	
acerbic	a.苦澀的；刻薄的	
acknowledge	v.承認；致謝	
acme	n.頂點，極點	
acolyte	n.(教士的)助手，侍僧	
acorn	n.橡子，橡果	
acoustic	a.聽覺的，有關聲音的	
acquaint	v.使…熟知；通知	
acquaintance	n.熟知；熟人	
acquainted	a.對某事物熟悉的；對某人認識的	
acquiesce	v.勉強同意，默許	
acquired	a.後天習得的	
acquisitive	a.渴望得到的，貪婪的	
acquit	v.宣告無罪；脫卸義務和責任；還清(債務)	
acquittal	n.宣告無罪，開釋	
acrid	a.辛辣的，刻薄的	
acrimonious	a.尖刻的，嚴厲的	
acrimony	n.尖刻，刻薄	
acrobat	n.特技演員，雜技演員	
acrophobia	n.恐高症	
acuity	n.(尤指思想或感官)敏銳	
acumen	n.敏銳，精明	
acute	a.靈敏的；[病]急性的	
adage	n.格言，古訓	
adamant	a.強硬的；固執的	
adapt	v.使…適應；修改	
adaptable	a.有適應能力的；可改編的	
addendum	n.補充，附錄	
addict	v./n.沉溺；上癮(者)	
addition	n.增加，附加	
additive	n.添加劑	
address	v.處理，對付，著手解決；致詞	
adept	a.老練的，精通的	
adequate	a.足夠的	
adhere	v.粘著	
adherent	n.擁護者，信徒	
adhesive	a.帶粘性的，膠粘的；n.膠合劑	
adjacent	a.接近的，毗連的	
adjourn	v.使延期，推遲；休會	
adjunct	n.附加物，附件	
adjust	v.整頓，整理；適應	
admire	v.欽佩，讚賞	
admission	n.許可；入會費；承認	
admonish	v.訓誡；警告	
adobe	n.泥磚，土坯	
adolescent	a.青春期的；n.青少年	
adopt	v.收養；採納	
adore	v.崇拜；熱愛	
adorn	v.裝飾	
adroit	a.熟練的，靈巧的	
adulate	v.諂媚，奉承	
adulterate	v.摻假	
adumbrate	v.(對將來事件)預示	
advent	n.到來，來臨	
adventitious	a.偶然的	
adverse	a.不利的，相反的；敵對	
advertise	v.做廣告	
advisable	a.適當的，可行的	
advocacy	n.擁護，支持	
advocate	v.擁護，支持，鼓吹；n.支持者，擁護者	
aegis	n.盾；保護，庇護	
aerate	v.充氣，讓空氣進入	
aerial	a.空中的，空氣中的	
aesthete	n.審美家	
aesthetic	a.美學的，有審美感的	
affable	a.易於交談的；和藹的	
affectation	n.做作，虛假	
affected	a.不自然的；假裝的	
affection	n.愛	
affidavit	n.宣誓書	
affiliate	v.加入；聯合	
affiliation	n.聯繫，聯合	
affinity	n.密切關係；吸引力	
affirm	v.確認；肯定	
affix	v.粘上，貼上；在合同上添寫某事物；n.詞綴	
afflict	v.使痛苦，折磨	
affliction	n.悲痛，受難的起因	
affluence	n.充裕，富足	
affluent	a.富裕的，豐富的	
affordable	a.能夠支付的	
affront	v.侮辱，冒犯	
agenda	n.議程	
agglomerate	v.凝聚，結塊	
aggrandize	v.增大，擴張；吹棒	
aggravate	v.加重，惡化	
aggregate	v.集合；合計	
aggression	n.侵略；敵對的情緒或行為	
aggressive	a.好鬥的；進取的	
aggressor	n.侵略者，攻擊者	
aggrieve	v.使受委屈；使痛苦	
agile	a.敏捷的，靈活的	
agility	n.敏捷	
agitate	v.攪動，煽動；使不安，使焦慮	
agitated	a.被鼓動的；不安的	
agnostic	a.不可知論的	
agog	a.興奮的，有強烈興趣的	
agony	n.極大痛苦	
agrarian	a.土地的	
agreeable	a.令人喜悅的；欣然同意的	
agronomy	n.農學，農藝學	
ail	v.生病	
airborne	a.空氣傳播的；空運的	
airtight	a.密閉的，不透氣的	
alabaster	a.雪白的	
alacrity	n.樂意，欣然；敏捷，活潑	
albeit	conj. 雖然，儘管	
alchemy	n.煉金術	
alcove	n.凹室	
alert	a.警惕的，機警的; n.警報	
alias	n.化名，別名	
alibi	n.某人當時不在犯罪現場的申辯或證明	
alienate	v.疏遠，離間某人	
align	v.將某物排列在一條直線上；與某人結盟	
alimentary	a.飲食的，營養的	
alkali	n.堿	
allay	v.減輕，緩和	
allege	v.(無證據)陳述，宣稱	
allegiance	n.忠誠，擁護	
allegory	n.寓言	
allergic	a.過敏的；對…討厭的	
allergy	n.過敏症；厭惡	
alleviate	v.緩和，減輕	
allocate	v.配給，分配	
allowance	n.津貼，補助；承認，允許	
allude	v.間接提到，暗指	
alluring	a.吸引人的，迷人的	
allusion	n.暗示，間接提示	
aloft	adv.在空中，在頭頂上	
aloof	a.冷淡的，疏遠的	
alphabetical	a.按字母表順序的	
alter	v.改變，更改	
alternate	a.輪流的，交替的；v.輪流，交替n.候選人，替代性選擇	
altruism	n.利他主義；無私	
altruistic	a.無私的，為他人著想的	
aluminium	n.鋁	
amalgam	n.混合物	
amalgamate	v.合併；混合	
amass	v.積聚	
amateur	n.業餘愛好者	
amateurish	a.業餘愛好的，不熟練的	
ambidextrous	a.十分靈巧的	
ambiguous	a.含糊的	
ambivalence	n.矛盾心理	
ambivalent	a.(對人或物)有矛盾看法的	
amble	n./v.漫步，緩行	
ambush	v.埋伏；伏擊	
ameliorate	v.改善，改良	
amenable	a.願服從的，通情達理的	
amend	v.修正；通常向更好的方向變化	
amendment	n.改正，修正；[法]修正案	
amenity	n.禮儀；使人感到舒適的事物	
amiable	a.和藹的，親切的	
amicable	a.友好的	
amity	n.(人或國之間的)友好關係	
amnesia	n.健忘症	
amnesty	n.大赦，特赦	
amorphous	a.無定形的	
amortize	v.分期償還	
amphibian	n.兩棲動物；水陸兩用飛行器	
ample	a.富足的；充足的	
amplify	v.放大；詳述	
amplitude	n.廣大，廣闊	
amulet	n.護身符	
amuse	v.使愉快，逗某人笑	
anachronistic	a.年代出錯的	
anaerobic	a.厭氧的	
anagram	n.變形詞	
analgesia	n.無痛覺，痛覺喪失	
analgesic	n.鎮痛劑；a.止痛的	
analogous	a.類似的	
analogy	n.相似；類比	
analyze	v.分析，分解	
anarchist	n.無政府主義者	
anarchy	n.無政府;政治上的混亂	
anathema	n.被詛咒的人；宗教意義的詛咒	
anatomical	a.解剖學的	
ancestor	n.祖先，祖宗	
ancestry	n.家系	
anchor	v.穩固；固定n.錨	
ancillary	a.輔助的；n.助手	
anecdote	n.短故事；軼事	
anemia	n.貧血，貧血症	
anesthetic	n.麻醉劑；a.麻醉的	
anguish	n.極大痛苦	
angular	a.有角的；(指人)瘦削的	
anhydrous	a.無水的	
animate	a.活的，有生命的；v.賦予生命	
animated	a.活潑的，生動的	
animation	n.活潑，有生氣；卡通製作	
animosity	n.憎惡，仇恨	
animus	n.敵意，憎恨	
annals	n.編年史	
annexation	n.併吞，合併	
annihilate	v.消滅	
annotate	v.注解	
announce	v.宣佈，發表；通報…的到來	
annoy	v.惹惱；打攪，騷擾	
annul	v.宣告無效；取消	
anomalous	a.反常的；不規則的	
anomaly	n.異常，反常	
anonymity	n.無名，匿名	
anonymous	a.匿名的	
anorexia	n.厭食症	
antagonism	n.反抗，敵意	
antagonize	v.使對抗；與…對抗	
Antarctic	a.南極的	
antecedence	n.居先，優先	
antecedent	n.前事；前輩；a.先行的	
antediluvian	a.史前的；陳舊的	
antenna	n.觸角；天線	
anterior	a.較早的，以前的	
anthem	n.聖歌；讚美歌，國歌	
anthology	n.詩集，文選	
anthropologist	n.人類學家	
antibiotic	n.抗生素	
antibody	n.抗體(身體中的抗病物質)	
antic	a.古怪的	
anticipate	v.預期，期待	
anticipatory	a.預想的，預期的	
anticlimax	n.令人掃興的結局	
antidote	n.解毒藥	
antihistamine	n.(治療過敏的)抗組胺劑	
antipathy	n.反感，厭惡	
antiquated	a.陳舊的，過時的	
antique	a.古時的，古老的；n.古物，古董	
antiquity	n.古；古人；古跡	
antiseptic	n.殺菌劑；a.防腐的	
antithesis	n.對立；相對	
anvil	n.鐵砧	
aorta	n.主動脈	
apex	n.頂點，最高點	
aphorism	n.格言	
apiary	n.養蜂場，蜂房	
aplomb	n.沉著，鎮靜	
apocalyptic	a.預示世界末日的；啟示的	
apocrypha	n.偽經，偽書	
apocryphal	a.假冒的，虛假的	
apogee	n.遠地點	
apologize	v.道歉；辯解	
apoplectic	a.中風的；憤怒的	
apostasy	n.背教，脫黨	
apostate	n.背教者；變節者	
apostrophe	n.書寫中撇號(表示省略或所有格)	
apothecary	n.藥劑師	
appall	v.使驚駭，使恐怖	
apparatus	n.儀器，設備	
apparel	n.(精緻的)衣服	
apparition	n.幽靈，神奇的現象	
appeal	v.懇求；吸引；上訴	
appease	v.使平靜，安撫	
appellation	n.名稱，稱呼	
appetite	n.欲望，食欲，愛好	
appetizer	n.開胃品	
appetizing	a.美味可口的，促進食欲的	
applaud	v.鼓掌表示歡迎或讚賞	
applause	n.鼓掌，喝彩	
applicable	a.生效的，適合的	
applicant	n.申請人	
application	n.請求，申請；應用，應用程式	
appoint	v.任命，指定；約會	
apposite	a.適當的，恰當的	
appraise	v.評價，鑒定	
appreciable	a.明顯的	
appreciate	v.欣賞；感激	
apprehend	v.逮捕；恐懼	
apprehensive	a.害怕的；有眼力的	
apprentice	n.學徒	
apprise	v.通知，告訴	
approach	v.接近，靠近；著手處理；n.方法	
approbation	n.稱讚，認可	
appropriate	v.撥款；盜用；a.恰當的	
approximate	a.大約的，估計的	
apron	n.圍裙	
apropos	a./adv.適宜的(地)；有關	
apt	a.易於…的，恰當的	
aptitude	n.適宜；才能，資質	
aquatic	a.水生的，水中的	
aqueduct	n.引水渠；高架渠	
aquifer	n.含水土層	
arabesque	n.蔓藤圖飾	
arable	a.可耕的，適合種植的	
arbiter	n.權威人士，泰斗	
arbitrary	a.專橫的，不理智的	
arbitrate	v.仲裁，公斷	
arboreal	a.樹木的	
arboretum	n.植物園	
arcane	a.神秘的，秘密的	
arch	n.拱門，拱形	
archaeology	n.考古學	
archetype	n.原型；典型例子	
archipelago	n.群島	
architect	n.建築師	
archive	n.檔案室	
arctic	a.北極的；極寒的	
ardent	a.熱心的，熱烈的	
arena	n.(角鬥的)競技場	
argot	n.隱語，黑話	
aria	n.獨唱曲，詠歎調	
arid	a.乾旱的；枯燥的	
aristocracy	n.貴族；貴族政府，貴族統治	
armada	n.艦隊	
armistice	n.休戰，停戰	
armory	n.軍械庫	
aroma	n.芳香，香氣	
aromatic	a.芬芳的，芳香的	
arouse	v.喚醒；激發	
array	v.部署；n.陳列；大批	
arrest	v.依法逮捕；阻止，抑制	
arresting	a.顯著的，引人注意的	
arrhythmic	a.無節奏的；不規則的	
arrogance	n.傲慢，自大	
arrogant	a.傲慢的，自大的	
arrogate	v.冒稱具有…權利	
arroyo	n.乾涸的河床；小河	
arsenal	n.軍械庫	
arson	n.縱火，放火	
artery	n.動脈，命脈	
arthritis	n.關節炎	
articulate	v.清楚說話	
artifact	n.人工製品	
artifacts	n.史前古器物	
artifice	n.巧辦法；詭計	
artificial	a.人造的，假的	
artistry	n.藝術技巧	
artless	a.粗俗的；自然的	
ascendancy	n.統治權，支配力量	
ascetic	a.禁欲的；n.苦行者	
ascribe	v.歸功於；歸咎於	
aseptic	a.潔淨的；無菌的	
asparagus	[植]蘆筍，龍鬚菜(可作蔬菜)	
aspect	n.(問題等的)方面；面貌，外表	
aspen	n.白楊	
asperity	n.嚴酷；粗魯	
aspersion	n.誹謗，中傷	
asphyxiate	v.(使)無法呼吸，窒息而死	
aspirant	n.有抱負者	
aspiration	n.抱負，熱望	
aspire	v.嚮往，有志於	
assail	v.抨擊；猛攻	
assault	n.突然襲擊；猛襲	
assay	v./n.試驗，測定	
assemble	v.集合，聚集	
assent	v.同意，贊成	
assert	v.斷言，主張	
assertive	a.過分自信的；有進取心的	
assertiveness	n.過分自信	
assess	v.確定，評定；估計…的品質	
assessment	n.估計，評價	
asset	n.財產；可取之處	
assiduous	a.勤勉的；專心的	
assimilate	v.同化；吸收	
associate	a.聯合的；n.合夥人；v.將人或事物聯繫起來	
assorted	a.混雜的	
assuage	v.緩和，減輕	
assume	v.假定	
assumption	n.設想；奪取	
assure	v.向某人保證，確信	
assured	a.自信的；確定的	
asterisk	n.星號	
asteroid	n.小行星	
asthma	n.哮喘症	
astound	v.使震驚	
astray	a.迷路的，誤入歧途的	
astringent	a.止血的，收縮的；n.收縮劑，止血劑	
astrolabe	n.星盤(古代星位觀測儀)	
astrology	n.占星術；占星學	
astronomical	a.龐大的	
astute	a.機敏的，精明的	
asunder	a./adv.分離的；化為碎片	
asylum	n.避難所，庇護所	
asymmetric	a.不對稱的	
athletics	n.運動，體育	
atonal	a.(音樂)無調的	
atrocious	a.殘忍的，兇惡的	
atrocity	n.殘暴，暴行	
atrophy	n.萎縮，衰退	
attach	v.將某物系在(另一物)上	
attain	v.達到，實現	
attainment	n.成就	
attenuate	v.變薄	
attest	(to)v.證明	
attic	n.閣樓，頂樓	
attorney	n.律師	
attribute	n.屬性，品質；v.把…歸於	
attune	(to)v.使調和	
auction	n.拍賣	
audacious	a.大膽的；愚勇的	
audible	a.聽得見的	
audience	n.聽眾，觀眾；讀者	
audit	v.審計，核對；旁聽	
auditorium	n.禮堂；觀眾席	
augment	v.增大，增值	
augur	n.占卜師；v.占卜	
augury	n.預言，徵兆，占卜	
august	a.威嚴的，高貴的	
auspices	n.資助，贊助	
auspicious	a.幸運的；吉兆的	
austere	a.樸素的	
austerity	n.樸素，艱苦	
authentic	a.真正的；法律證實的	
authenticity	n.確實性，真實性	
authoritarian	n.獨裁主義者；極權主義者	
authorization	n.授權，認可	
autobiography	n.自傳	
autocracy	n.獨裁政府	
autocrat	n.獨裁者	
autonomous	a.自治的	
autonomy	n.自治，獨立	
auxiliary	a.輔助的，協助的	
available	a.可用的，可得到的	
avalanche	n.雪崩	
avant-garde	n.(藝術)先鋒派	
avarice	n.貪財，貪婪	
avaricious	a.貪婪的，貪心的	
avenge	v.為…復仇，為…報仇	
aver	v.極力聲明；斷言；確證	
averse	a.不願的，反對的	
aversion	n.嫌惡，憎恨	
avert	v.避免，防止	
aviary	n.大鳥籠，鳥舍	
avid	a.渴望的	
avoid	v.避開，躲避	
avow	v.承認；公開宣稱	
awe	n./v.敬畏	
awe-inspiring	a.令人敬畏的	
awkward	a.笨拙的；難用的；不便的	
awl	n.(鑽皮革的)尖鑽	
awning	n.遮陽蓬，雨蓬	
awry	a.扭曲的，走樣的	
axiom	n.公理；定理	
axis	n.軸(常為虛構之線，如地球軸)	
axle	n.輪軸(連接兩個車輪的軸)	
babble	v.胡言亂語；牙牙學語；喋喋不休	
backdrop	n.(事情的)背景，背景幕布	
backhanded	a.間接的；反手擊球的	
backset	n.倒退	
bacteria	n.細菌，培養基	
bacterium	n.細菌	
badge	n.徽章(如校徽等)	
badger	n.獾；v.一再煩擾，一再要求	
badinage	n.開玩笑，打趣	
bail	n.保釋金	
bait	n.誘餌；v.逗弄；激怒	
bale	n.大包裹；災禍，不幸	
baleful	a.邪惡的，惡意的	
balk	n.大方木料；v.妨礙；(因困難等)不願前進或從事某事	
ballad	n.歌謠，小曲	
ballast	n.(船等)壓艙物	
ballerina	n.芭蕾舞女演員	
balloon	n.氣球；v.快速增加	
ballot	n./v.投票	
balm	n.香油，藥膏；鎮痛劑	
balmy	a.(氣候)溫和的；芳香的	
ban	n.禁令	
banal	a.陳腐的	
band	n.帶子；收音機波段	
bandage	n.繃帶；v.用繃帶包紮	
bane	n.禍根	
banish	v.放逐某人	
banister	n.(樓梯的)欄杆	
bankrupt	a.破產的	
banquet	n.宴會，盛宴	
banter	n.打趣，玩笑	
bar	v.禁止，阻擋；n.條，棒	
barb	n.(魚鉤的)倒鉤；嚴厲的批評	
barbarous	a.野蠻的；殘暴的	
barbecue	n.烤肉架；烤肉	
bard	n.吟游詩人	
bare	v.暴露；a.赤裸的	
barefaced	a.厚顏無恥的，公然的	
bargain	n.交易; 物美價廉的東西；v.討價還價	
barge	n.平底貨船，駁船	
bark	v./n.狗吠；n.樹皮	
barn	n.穀倉，牲口棚	
barometer	n.氣壓計；晴雨錶	
baroque	n./a.(藝術、建築等)過分雕琢(的)	
barrage	n.彈幕	
barren	a.不育的；貧瘠的；不結果實的	
barricade	v.設柵阻擋；n.柵欄	
barrier	n.路障；障礙	
barter	v.易貨貿易	
base	a.卑鄙的	
bask	v.曬太陽，取暖	
baste	v.倒油脂於(烤肉上，以防烤幹)	
batch	n.一批，一爐	
bathetic	a.假作悲傷的；陳腐的	
baton	n.指揮棒(指揮家用)；警棍	
battalion	n.軍營，軍隊	
bauxite	n.鋁土岩(產鋁的礦土、石)	
bawdy	a.淫猥的，好色的	
bazaar	n.集市，商店集中區	
beacon	n.烽火；燈塔	
beam	n.(房屋等)大樑；光線	
bearing	n.關係，意義；方位	
beat	v.心跳；攪拌	
bedeck	v.裝飾，修飾	
bedlam	n.混亂，騷亂	
befuddlement	n.迷惑不解	
begrudge	v.吝嗇，勉強給	
beholder	n.目睹者，旁觀者	
behoove	v.理應，有義務	
belabor	v.過分冗長地做或說；痛打	
belated	a.來得太遲的	
beleaguer	v.圍攻；騷擾	
belie	v.掩飾；證明為假	
belittle	v.輕視，貶抑	
bellicose	a.好戰的，好鬥的	
belligerence	n.交戰；好戰性，鬥爭性	
bellwether	n.領導者，領頭羊	
bench	n.法官席；長凳	
bend	v.彎曲；屈服	
benediction	n.祝福；祈禱	
benefactor	n.行善者，捐助者	
benevolent	a.善心的，仁心的	
benign	a.慈祥的	
benison	n.祝福，賜福	
bent	n.特長，愛好；a.彎曲的	
bequeath	. 遺贈	
bequest	n.遺產，遺贈物	
berate	v.猛烈責?	
bereft	a.被剝奪的；缺少的	
beset	v.鑲嵌；困擾	
besiege	v.圍攻，困擾	
besmirch	v.誹謗	
bestial	a.野獸的，殘忍的	
bestow	v.給予，賜贈	
betray	v.背叛；暴露	
betroth	v.許配，和…訂婚	
beverage	n.飲料	
bewilder	v.迷惑，混亂	
bewildering	a.令人迷惑的；費解的	
bibliography	n.文獻學；參考書目	
bibliophile	n.愛書者，藏書家	
bicker	v.為小事爭吵	
bid	v.命令；出價，投標	
bifurcate	v.分為兩支，分叉	
bigot	n.(宗教、政治等的)盲信者；心胸狹窄者	
bile	n.膽汁	
bilingual	a.(說)兩種語言的	
bilk	v.躲債；騙取	
billowy	a.如波浪般翻滾的	
bin	n.大箱子	
biosphere	n.生命層，生物圈	
biped	n.二足動物	
bit	n.鑽頭	
bizarre	a.奇異的，古怪的	
blade	n.刀鋒，刀口	
blanch	v.使變白；使(臉色)變蒼白	
bland	a.(人)情緒平穩的；(食物)無味的	
blandishment	n.奉承，甘言勸誘	
blasphemy	n.褻瀆，瀆神	
blast	n.一陣(大風)；衝擊波；v.爆破；枯萎	
blatant	a.厚顏無恥的；顯眼的；炫耀的	
blazon	n.紋章，裝飾；v.精確描繪	
bleach	v.漂白	
bleak	a.寒冷的；陰沉的；陰鬱的，暗淡的	
blemish	v.損害；玷污；n.瑕疵，缺點	
blight	n.植物枯萎病；v.使…枯萎	
blighted	a.枯萎的；衰老的	
bliss	n.狂喜；福佑，天賜的福	
blissful	a.極幸福的	
blithe	a.快樂的，無憂無慮的	
blizzard	n.暴風雪	
blockade	v./n.封鎖	
blockage	n.障礙物	
blooming	a.有花的；精力旺盛的	
blotch	n.(皮膚上的)紅斑點；(墨水等)大斑點	
blowhard	n.自吹自擂者	
blue	a.憂傷的，沮喪的	
blueprint	n.藍圖；方案	
blunder	v.犯大錯；笨拙地做；n.愚蠢之舉	
blunt	a.鈍的；直率的；v.變鈍	
blur	n.模糊不清的事物；v.使…模糊	
blurb	n.簡介；印在書籍封套上的推薦廣告	
blurt	v.脫口而出	
blush	v.因某事物臉紅；n.因羞愧等臉上泛出的紅暈	
bluster	v.(指風)猛刮	
blustering	a.大吵大鬧的	
boast	v./n.自誇	
bodyguard	n.保鏢，侍衛	
bog	n.沼澤；v.使…陷入泥沼	
boggle	v.畏縮不前；使退縮	
bogus	a.假裝的，假的	
boisterous	a.喧鬧的；猛烈的	
bolster	n.枕墊；v.支持，鼓勵	
bolt	v.急逃(to dash out; dart)；螺栓，門栓	
bombast	n.高調，誇大之辭	
bombastic	a.誇誇其談的	
bondage	n.奴役，束縛	
bonnet	n.圓帽，扁平軟帽	
boom	n.繁榮昌盛時期；v.發出深沉有迴響的聲音	
boon	n.恩惠，天賜福利	
boor	n.舉止粗野的人；鄉下人	
boost	v.往上推；增加，提高	
bootless	a.無益處的；無用的	
bore	v.鑽孔；使厭煩；n.孔；令人厭煩的人	
boredom	n.厭煩；令人厭煩的事物	
boring	a.無趣的，乏味的	
botany	n.植物學	
boulder	n.巨礫	
bouquet	n.花束；芳香	
bourgeois	a.中產階級的；自私拜物的	
bout	n.一回合，一陣	
boycott	v.抵制(貿易)	
brace	v.使穩固，架穩；n.支撐物	
bracelet	n.手鐲，臂鐲	
bracing	a.令人振奮的	
bracket	n.托架，支架	
brag	v.吹噓	
braggadocio	n.吹牛大王；大吹大擂	
braggart	n.吹牛者	
braid	n.穗子；髮辮；v.編成辮子	
brake	n.?車；v.減速，阻止	
brand	n.商標；烙印；v.在某事物上打烙印	
brandish	v.(威脅性地)揮舞	
brash	a.性急的；無禮的	
brassy	a.厚臉皮的，無禮的	
brat	n.孩子；頑童	
bravado	n.故作勇敢，虛張聲勢	
bravura	n.華美樂段；a.華美的；顯示技巧的	
brawl	v./n.爭吵，打架	
brazen	a.厚臉皮的	
breach	n.裂縫，缺口；v.打破，裂開；違背	
breadth	n.寬度	
breed	v.繁殖；教養；n.品種，種類	
bribe	v.賄賂	
bricklayer	n.砌磚蓋房者，泥瓦匠	
bridle	n.馬籠頭；v.抑制，控制	
brink	n.(峭壁的)邊沿，邊緣	
brisk	a.敏捷的，活潑的；清新健康的	
bristle	n.短而硬的毛髮；v.(毛)豎起；發怒	
brittle	a.易碎的，脆弱的	
broach	v.開瓶；提出(討論)	
brochure	n.小冊子，說明書	
broker	n.經紀人	
bromide	n.平庸的人或話	
brood	n.一窩幼鳥；v.孵蛋；冥想	
brook	n.小河	
browbeat	v.欺侮；嚇唬	
bruise	v.受傷，擦傷	
bruit	v.散佈(謠言)	
brunt	n.主要衝擊力或影響	
brusque	a.唐突的，魯莽的	
brutal	a.殘忍的；嚴酷的	
brute	n./a.野獸(的)；殘忍的(人)	
buck	v.反對；n.雄鹿；雄兔	
bucket	n.圓桶	
bucolic	a.鄉村的；牧羊的	
bud	n.芽；花蕾	
budge	v.移動一點兒；改變立場	
budget	n.預算	
buffoon	n.演出時的丑角；粗俗而愚蠢的人	
bulb	n.植物的球莖；燈泡	
bulge	n./v.膨脹，鼓起	
bulk	n.體積；數量；大多數；大身軀	
bully	v.以強欺弱，威脅；n.欺負別人者	
bumptious	a.傲慢的，自誇的	
bungle	v.粗製濫造	
buoy	n.浮標；救生圈；v.支持，鼓勵	
buoyant	a.有浮力的；快樂的	
bureaucracy	n.官僚政治	
burgeon	v.迅速成長，發展	
burial	n.埋葬，埋藏	
burlesque	n.諷刺或滑稽的戲劇	
burnish	v.擦亮，磨光	
bust	n.半身(雕)像	
butt	v.用頭抵撞，頂撞；n.粗大的一端；煙蒂	
buttress	n.拱牆，拱壁；v.支持	
byline	n.(列作者名字的)報刊文章首行	
byproduct	n.副產品；副作用	
bystander	n.旁觀者	
Byzantine	a.像迷宮似的；難變更的	
cabal	n.政治陰謀小集團	
cabinet	n.櫥櫃；內閣	
cache	n.貯藏處；v.將…藏於	
cacophonous	a.發音不和諧的，不協調的	
cacophony	n.難聽的聲音	
cadet	n.軍校或警官學校的學生	
cadge	v.乞討；佔便宜	
cajole	v.(以甜言蜜語)哄騙	
calamity	n.大災禍，不幸之事	
calcium	n.鈣	
calculated	a.蓄意的	
calculating	a.深謀遠慮的，精明的	
calculus	n.微積分學；結石	
caldron	n.(煮湯用的)大鍋	
calibrate	v.量…口徑；校準	
calipers	n.測徑器，雙腳規	
calligraphy	n.書法	
callous	a.結硬塊的	
callow	a.(鳥)未生羽毛的；(人)未成熟的	
calorie	n.卡路里；卡(熱量單位)	
calumniate	v.誹謗，中傷	
calumny	n.誹謗，中傷	
cameo	n.浮雕寶石；生動刻畫；(演員)出演	
camouflage	n./v.掩飾，偽裝	
campaign	n.戰役；競選活動	
canary	n.金絲雀；女歌星	
candid	a.率直的	
candidacy	n.候選人的資格	
candidate	n.候選人；參加考試的人	
candor	n.坦白，率直	
cane	n.拐杖	
canine	a.犬的，似犬的	
canny	a.精明仔細的	
canon	n.經典，真作	
canonical	a.符合規定的；經典的	
canopy	n.蚊帳，華蓋	
cant	n.斜坡，斜面；隱語，術語，黑話；v.使傾斜	
cantankerous	a.脾氣壞的，好爭吵的	
canto	n.(長詩的)篇	
canvas	n.畫布；帆布	
canvass	v.細查；拉選票	
canyon	n.峽谷	
cape	n.披肩，短斗篷；海角	
capillary	n.毛細血管	
capitulate	v.(有條件地)投降	
caprice	n.奇思怪想，變化無常，任性	
capricious	a.變化無常的，任性的	
capsule	n.莢；膠囊	
caption	n.標題	
captious	a.吹毛求疵的	
captivate	v.迷惑，吸引	
capture	v.俘獲；奪取或贏得；n.戰利品	
carafe	n.玻璃瓶	
carapace	n.(蟹或龜等的)甲殼	
carbohydrate	n.碳水化合物	
carcinogen	n.致癌物	
cardinal	a.最重要的；n.紅衣主教	
cardiologist	n.心臟病專家	
caress	n.愛撫，撫摸；v.愛撫或撫摸某人	
careworn	a.受憂慮折磨的，飽經風霜的	
cargo	n.(船、飛機等裝載的)貨物	
caricature	n.諷刺畫；滑稽模仿	
carnivorous	a.肉食動物的	
carol	n.讚美詩，頌歌；v.歡唱	
carouse	n.狂飲尋樂	
carp	n.鯉魚；v.吹毛求疵	
carpenter	n.木匠	
carrion	n.腐肉	
cartographer	n.繪製地圖者	
cartoon	n.漫畫	
carve	v.雕刻	
cast	n.演員陣容；劇團；v.扔；鑄造	
caste	n.社會等級，等級	
castigate	v.懲治，嚴責	
castigation	n.懲罰，苛評	
casual	a.偶然的	
casualty	n.傷亡事故；傷亡者	
cataclysm	n.劇變，災難(常指大洪水或地震)	
catalog	n.目錄；系列	
catalyst	n.催化劑；促使事情發展的因素	
catastrophe	n.突如其來的大災難	
categorical	a.無條件的，絕對的；分類的	
category	n.類別，範疇	
cater	v.迎合；提供飲食及服務	
caterpillar	n.毛毛蟲，蝴蝶的幼蟲	
catharsis	n.宣洩，淨化	
cathedral	n.總教堂，主教堂	
catholic	a.普遍的；廣泛的；(人)寬厚的	
caucus	n.政黨高層會議	
caulk	v.填塞(隙縫使不漏水)	
causal	a.原因的，因果關係的	
caustic	a.腐蝕性的；刻薄的；n.腐蝕劑	
cauterize	v.(用腐蝕性物質或烙鐵)燒灼(表皮組織)以消毒或止血	
cavalier	n.騎士，武士	
cavalry	n.騎兵部隊，裝甲部隊	
caveat	n.警告，告誡	
cavern	n.大洞穴	
cavil	v.挑毛病，吹毛求疵	
cavity	n.(牙齒等的)洞，腔	
cavort	v.騰越，歡躍	
cede	v.割讓(土地權利)，放棄	
celebrated	a.有名的，知名的	
celebrity	n.名聲；知名人士	
celestial	a.天體的，天上的	
cellar	n.地下室；酒窖	
cello	n.大提琴	
cement	n.水泥；膠粘劑；v.粘合，鞏固	
censor	v.審查，檢查(書報)	
census	n.人口統計	
centaur	n.人頭馬怪物	
centigrade	a.百分度的，攝氏溫度計的	
centralization	n.集中；集權化	
centurion	n.古羅馬的百人隊長	
ceramic	n.陶瓷製品；a.陶器的	
ceramics	n.制陶業)；陶器	
cereal	n.穀類；穀類食品	
cerebral	a.大腦的；深思的	
ceremonious	a.儀式隆重的	
ceremony	n.典禮，儀式	
certainty	n.確定的事情	
certification	n.證明	
certitude	n.確定無疑	
cessation	n.中止，(短暫的)停止	
cession	n.割讓，轉讓	
chafe	v.摩擦生熱；擦痛；激怒	
chaff	n.穀物的皮殼，米糠	
chagrin	v./n.失望，懊惱	
chalice	n.大酒杯；聖餐杯	
chameleon	n.變色龍，蜥蜴；善變之人	
champion	n.冠軍；鬥士；擁護者；v.擁護	
championship	n.冠軍地位；錦標賽	
chancellor	n.大臣，總理，首席法官，大學校長	
chandelier	n.枝形吊燈(燭臺)	
chant	n.聖歌；v.歌唱或背誦	
chaos	n.混亂	
chapel	n.(附屬於教堂或監獄等的)小教堂	
char	v.燒焦；使…燃燒成焦炭	
characteristic	a.有特色的；典型性的；n.與眾不同的特徵	
characterization	n.描繪，刻畫	
characterize	v.描述或刻畫…的特點	
charade	n.用動作等表演文字意義的字謎遊戲	
charisma	n.(大眾愛戴的)領袖氣質；魅力	
charitable	a.仁慈的；寬厚的	
charity	n.仁慈；施捨	
charlatan	n.江湖郎中，騙子	
charm	n.魅力；咒語，咒符	
charter	n.(公司)執照；憲章；v.包租車船	
chary	a.小心的，審慎的	
chase	v.雕鏤；追捕	
chasm	n.深淵，大溝；大差別	
chaste	a.貞潔的；樸實的	
chastise	v.嚴厲懲罰；譴責	
chauvinistic	a.沙文主義的，過分愛國主義的	
check	v.使突然停止，阻止	
chef	n.廚師	
cherubic	a.(尤指孩子)胖乎乎而天真無邪的	
chicanery	n.詭計，狡詐	
chide	v.叱責，指責	
chimera	n.神話怪物；夢幻	
chip	n.薄片，碎片；積體電路片	
chipmunk	n.花栗鼠(像松鼠的美洲小動物)	
chisel	n.鑿子；v.鑿；欺騙	
chivalrous	a.武士精神的；對女人彬彬有禮的	
choice	a.上等的；精選的	
choir	n.(教堂的)歌唱隊	
choke	v.(使)窒息，阻塞	
choleric	a.易怒的，暴躁的	
chord	n.和絃，和音	
choreography	n.舞蹈；舞蹈編排	
chorus	n.合唱隊，歌舞團	
chromatic	a.彩色的，五彩的	
chromosome	n.染色體	
chronic	a.慢性的，長期的	
chrysanthemum	n.菊，菊花	
chuckle	v.輕聲地笑	
churl	n.粗鄙之人	
cinder	n.餘燼，礦渣	
cipher	n.零；無影響力的人；密碼	
circuit	n.環行，環行道；線路；電路	
circuitous	a.迂回的，繞圈子的	
circular	a.圓形的	
circulate	v.迴圈；流通；發行	
circulation	n.迴圈，流通；發行額	
circumference	n.周圍；圓周；周長	
circumlocution	n.迂回累贅的陳述	
circumscribe	v.限制	
circumstantial	a.不重要的，偶然的；描述詳細的	
circumvent	v.回避；用計謀戰勝或規避	
cistern	n.貯水池	
cite	v.引用，引述	
civil	a.國內的；公民的；文明的	
civilian	n.平民	
civility	n.彬彬有禮，斯文	
claim	v.要求或索; 要n.聲稱擁有的權力	
clairvoyance	n.超人的洞察力	
clam	n.蛤蜊，蛤肉；守秘密之人	
clamor	v./n.吵鬧，喧嘩	
clamp	n.鉗子；v.鉗緊	
clandestine	a.秘密的，暗中從事的	
clannish	a.排他的，門戶之見的	
clarify	v.澄清	
clarion	a.聲音高而清晰的；n.尖音小號聲；尖音小號	
clarity	n.清楚	
clash	v.衝突，撞擊	
clasp	n.鉤子，扣子；緊握	
classify	v.分類，歸類	
clause	n.從句；(法律等)條款	
clay	n.黏土	
cleavage	n.裂縫；分裂	
cleave	v.劈開；分裂	
cleaver	n.切肉刀	
cleft	n.裂縫；a.劈開的	
clemency	n.溫和；仁慈，寬厚	
clement	a.仁慈的；溫和的	
clientele	n.(醫生、律師的)顧客，(商店的)常客	
climax	n.頂點，高潮	
clinch	v.釘牢；徹底解決	
cling	v.緊抓住；捨不得放棄	
clinical	a.臨床的；冷靜客觀的	
clip	n.夾子，別針；v.修剪	
clipper	n.大剪刀；快速帆船	
clique	n.朋黨派系，小集團	
clog	n.障礙; v.阻塞	
cloister	n.修道院	
closet	n.壁櫥；a.秘密的	
clot	n.凝塊；v.使凝結成塊	
cloture	n.辯論的終結	
cloudburst	n.大暴雨，豪雨	
clout	n.用手猛擊；權力，影響力	
clown	n.小丑；v.扮小丑	
cloying	a.甜得發膩的	
clumsy	a.笨拙的；拙劣的	
cluster	n.串，束，群；v.成群，成串	
coagulant	n.凝結劑；凝血劑	
coagulate	v.使凝結	
coagulation	n.凝固	
coalesce	v.聯合，合併	
coalition	n.結合，聯合	
coarse	a.粗糙的；低劣的；粗俗的	
coarsen	v.使某物變粗糙	
coax	v.哄誘，巧言誘哄	
cob	n.玉米棒子；雄天鵝	
cobbler	n.補鞋匠	
cocoon	n.繭	
coda	n.樂曲的尾聲	
coddle	v.溺愛；悉心照料	
code	n.密碼；法典；v.將某事物編寫成密碼	
codify	v.將法律、規則等編成法典	
coerce	v.強迫；壓制	
coercion	n.強制，高壓統治	
coeval	a.同年代的	
cogent	a.有說服力的	
cogitate	v.慎重思考，思索	
cognizance	n.認識，察識，知識	
cognizant	a.知道的，認識的	
cohabit	v.共棲	
coherent	a.連貫的，一致的	
cohesion	n.內聚力；凝聚力	
cohesive	a.凝聚的	
coincide	v.巧合；一致	
colander	n.濾器，漏勺	
cold-blooded	a.[生]冷血的；殘酷的	
collaborate	v.合作，協作；通敵	
collage	n.拼貼畫	
collapse	v.坍塌，塌陷;虛脫，暈倒	
collar	n.衣領；戴在動物頸部的項圈	
collate	v.對照，核對	
collateral	a.平行的；旁系的；n.擔保品	
collected	a.泰然自若的	
collection	n.收藏品	
collision	n.碰撞，衝突	
colloquial	a.口語的，口頭的	
colloquium	n.學術討論會	
collude	v.串通，共謀	
colon	n.冒號	
colonize	v.建立殖民地	
colonnade	n.柱廊	
colony	n.菌群；殖民地	
coloration	n.著色法，染色法；顏色，色澤	
colossal	a.巨大的，龐大的	
colossus	n.巨人；巨型雕像	
coltish	a.似小馬的；不受拘束的	
coma	n.昏迷狀態	
comatose	a.昏迷的	
combat	n./v.格鬥，搏鬥	
combustible	a.易燃的；易激動的	
comedienne	n.說笑話、演滑稽劇等的女演員	
comely	a.動人的，美麗的	
comic	a.可笑的；喜劇的；n.喜劇演員	
comity	n.禮讓，禮儀	
comma	n.逗號	
commemorate	v.紀念(偉人、大事件等)	
commence	v.開始，宣導	
commencement	n.開始；(大學的)畢業典禮	
commensurate	a.同樣大小的；相稱的	
commentary	n.實況報導；(對書等的)集注	
commingle	v.攙和，混合	
commission	n.委託；傭金	
commit	v.託付；承諾；犯罪	
committed	a.(對事業，本職工作等)盡忠的	
commodious	a.寬敞的	
commodity	n.商品	
commonplace	a.平常的	
commonsense	a.具有常識的	
commonwealth	n.共和國，聯邦	
commotion	n.騷動，動亂	
communal	a.全體共用的，共用的	
commune	n.公社；v.與某人親密地交談	
communicate	v.傳送資訊，溝通	
commute	v.交換；坐公車上下班	
compact	a.結實的；簡潔的；n.合同，協議	
companion	n.同伴，同夥；受雇的陪伴人	
comparison	n.比較，對照；比喻	
compartment	n.隔間，車廂	
compass	n.指南針，羅盤；界限，範圍	
compassion	n.同情，憐憫	
compassionate	a.有同情心的	
compatible	a.和諧共處的，相容的	
compatriot	n.同胞，同國人	
compel	v.強迫	
compelling	a.引起興趣的	
compendium	n.簡要，概略	
compensate	v.補償，賠償	
compensatory	a.補償性的，報酬的	
compete	v.競爭，對抗	
competence	n.勝任，能力	
compile	v.彙集；編輯	
complacency	n.滿足，安心	
complacent	a.自滿的，得意的	
complaisance	n.彬彬有禮，殷勤，柔順	
complaisant	a.順從的，討好的	
complementary	a.互補的	
compliance	n.順從，遵從	
compliant	a.服從的，順從的	
complicate	v.使某事複雜化	
compliment	n./v.恭維，稱讚	
comply	v.遵循，順從	
component	n.成分，零部件	
compose	v.寫，創作；組成	
composed	a.鎮定的，沉著的	
composer	n.作曲家	
compost	n.混合肥料	
composure	n.鎮靜，沉著；自若	
compound	n.複合物；v.攙和	
comprehend	v.理解；包括	
comprehensible	a.能充分理解的	
comprehensive	a.全面的，綜合的	
compress	v.壓縮，濃縮	
compromise	v.妥協；危害	
compulsion	n.強迫；難以抗拒的衝動	
compunction	n.懊悔，良心不安	
concatenate	v.連結；連鎖	
concave	a.凹的	
conceal	v.隱藏，隱瞞	
concede	v.承認(為正確)；讓步	
conceit	n.自負，自大	
conceive	v.想像，構想；懷孕	
concentrate	v.集中，濃縮	
conception	n.概念；開始	
concerto	n.協奏曲	
concession	n.讓步	
conciliate	v.安撫，馴服	
conciliatory	a.撫慰的，調和的	
concise	a.簡潔的	
conclave	n.秘密會議	
conclusive	a.最後的，結論的；確鑿的，消除懷疑的	
concomitant	a.伴隨而來的	
concord	n.和睦；公約	
concrete	a.具體存在的；n.混凝土	
concur	v.意見相同，一致	
concussion	n.腦震盪；強烈震動	
condemn	v.極力譴責；判刑	
condense	v.濃縮	
condescend	v.屈尊，俯就	
condescending	a.謙遜的，故意屈尊的	
condone	v.寬恕，原諒	
conducive	a.有助於…的	
conduct	n.品德，行為；v.領導，引導	
conduit	n.管道，引水道；水管	
cone	n.松果；圓錐體	
confection	n.甜食，糖果	
confederacy	n.聯盟或同盟	
confer	v.討論，商談；贈予	
conference	n.討論會，協商會	
confess	v.承認，供認	
confide	v.信賴，傾訴	
confidence	n.信任，自信，信心	
confidential	a.機密的	
configuration	n.結構，配置；輪廓	
confine	v.限制，禁閉	
confirm	v.證實，證明	
confiscate	v.沒收；充公	
conflagration	n.建築物或森林大火	
conflate	v.合併	
conflict	v./n.鬥爭，戰鬥；衝突，抵觸	
conform	(to)v.符合或遵守公認的規則	
conformist	n.尊奉者，英國國教徒	
conformity	n.一致，遵從；順眾	
confound	v.使迷惑，搞混	
confront	v.面臨；對抗	
congeal	v.凍結，凝固	
congenial	a.意氣相投的；性情好的	
congest	v.使擁擠；充血	
conglomerate	v.集聚成團	
congregate	v.聚集，集合	
congruent	a.全等的，一致的	
congruous	a.一致的，符合的；[數]全等的	
conifer	n.針葉樹	
conjecture	v./n.推測，臆測	
conjoin	v.使結合	
conjunction	n.聯合；連詞	
conjure	v.懇求，祈求；變魔術，變戲法	
connive	v.默許；縱容	
connoisseur	n.鑒賞家，行家	
connotation	n.言外之意，含蓄義	
conquer	v.以武力征服	
conquest	n.征服；戰利品	
conscience	n.良心，是非感	
conscientious	a.盡責的；小心謹慎的	
conscript	v.強行徵兵，徵召	
consensus	n.意見一致	
consent	v.同意，允許	
consequence	n.結果；重要性；價值	
consequential	a.傲慢的，自以為是的	
conservative	a.保守的，守舊的	
conservatory	n.溫室；音樂學院	
conserve	v.保全，保存	
considerable	a.相當多的；值得考慮的	
consign	v.托運；托人看管	
consistency	n.一致性；堅實度，可靠性；不矛盾	
consistent	a.前後一致的	
console	v.安慰，撫慰	
consolidate	v.鞏固；(使)堅強；合併	
consolidation	n.合併，鞏固	
consonant	a.調和的，一致的	
conspicuous	a.顯著的，顯而易見的	
conspiracy	n.共謀，陰謀	
conspire	v.陰謀，共謀	
constant	a.穩定的，不變的; n.常數	
constellation	n.星座，星群	
consternation	n.大為吃驚，驚駭	
constituent	n.成分；選區內的選民	
constitute	v.組成，構成；建立	
constitution	n.憲法；體質	
constitutional	a.章程的，法規的；素質上的，本質的	
constrain	v.束縛，強迫；限制	
constrained	a.束縛的，節制的	
constraint	n.強制，強迫；對感情的壓抑	
constrict	v.壓縮，收縮	
construct	v.建築，構成	
construe	v.解釋；翻譯	
consul	n.領事	
consummate	a.完全的，完善的；v.完成	
contact	n./v.接觸；互通資訊	
contagious	a.傳染的，有感染力的	
contain	v.包含，含有；控制；阻止，遏制	
containment	n.阻止，遏制	
contaminate	v.使…受污染	
contemplate	v.深思	
contempt	輕視，鄙視	
contemptible	a.令人輕視的	
contemptuous	a.鄙視的，表示輕蔑的	
contend	v.與對手競爭；據理力爭	
content	a.知足的，滿意的；n.內容；滿意	
contented	a.心滿意足的	
contention	n.爭論；論點	
contentious	a.好辯的，善爭吵的	
contest	v.競爭；對…表示懷疑	
context	n.(語句等的)上下文	
contiguous	a.接壤的，接近的	
continent	a.自製的；n.大陸	
contingent	a.意外的；視情況或條件而定的	
continuation	n.繼續，延續	
contort	v.(使)扭曲(deform)；曲解	
contraband	n.違禁品，走私貨	
contract	n.合同；v.訂合同；收縮	
contradict	v.反駁，駁斥	
contradictory	a.反駁的，反對的，抗辯的	
contrast	v./n.對比	
contravene	v.違背(法規，習俗等)	
contrite	a.悔罪的，痛悔的	
contrition	n.悔罪，痛悔	
contrive	v.計畫，設計	
contrived	a.不自然的，做作的	
control	n.實驗對照組	
controversial	a.引起或可能引起爭論的	
controvert	v.反駁，駁斥	
contumacious	a.違抗的，不服從的	
conundrum	n.(答案有雙關意義的)謎語；難題	
convalesce	v.(病)康復，復原	
convalescent	a./n.康復中的(病人)	
convenience	n.便利，有益；方便(的用具，機械等)	
conventional	a.因循守舊的，傳統的	
converge	v.會聚，集中於一點	
convergent	a.會聚的	
conversant	a.精通的，熟知的	
converse	v.談話；a.逆向的n.相反的事物	
convert	v.使改變(信仰等)；n.改變信仰的人	
convertible	a.可轉換的；n.敞篷車	
convex	a.凸出的	
convey	v.運載，運送；表達	
convict	v.定罪；n.罪犯	
conviction	n.判罪；堅信	
convince	v.使某人確信；說服	
convivial	a.歡樂的，狂歡的	
conviviality	n.歡樂；交遊	
convoke	v.召集	
convoluted	a.旋繞的；費解的	
convulse	v.使震動，震驚	
convulsion	n.騷動；痙攣	
coop	n.(雞)籠，欄	
cooperate	v.與他人合作	
cooperative	a.聯營的，合作的；願意協助的	
coordinate	n.同等物，座標；v.使各部分協調; a.同等的	
copious	a.豐富的，多產的	
cord	n.考得(木材堆的體積單位，等於128立方英尺，3.6246立方米)；繩索	
core	n.果心；核心)；v.去掉某物的中心部分	
cornucopia	n.象徵豐收的羊角(羊角裝飾器內裝滿花、果、穀物等以示富饒)	
coronation	n.加冕	
corporate	a.團體的；共同的	
corporeal	a.肉體的，身體的；物質的	
corpuscle	n.血球，細胞	
corral	n.(牛、馬等)畜欄	
correspondent	a.符合的；n.記者	
corroborate	v.支持或證實；強化	
corrode	v.腐蝕，侵蝕	
corrosive	a.腐蝕性的，腐蝕的，蝕壞的	
corrugate	v.(使)起波浪形，起皺紋	
corrugated	a.起皺紋的	
corrupt	a.墮落的，腐敗的；文體有錯誤的	
cosmic	a.宇宙的	
cosmopolitan	n.世界主義者，四海為家的人	
cosmopolitanism	n.世界性，世界主義	
cosmos	n.宇宙	
cosset	v.寵愛，溺愛	
costume	n.服裝；劇裝	
coterie	n.(有共同興趣的)小團體	
coterminous	a.毗連的，有共同邊界的	
cougar	n.美洲豹	
countenance	v.支持，贊成；容忍；n.表情	
counteract	v.消除，抵消	
counterbalance	v.起平衡作用	
counterfeit	v.偽造，仿造	
countermand	v.撤回(命令)，取消(訂貨)	
counterpart	n.相對應或具有相同功能的人或物	
counterproductive	a.事與願違的	
coup	n.意外而成功的行動	
court	n.法庭，法院；宮廷，朝廷；v.獻殷勤；追求	
covenant	n.契約；v.立書保證	
covert	a.秘密的，隱密的	
covet	v.貪求，妄想	
cow	v.威脅	
coward	n.膽小鬼	
cower	v.畏縮，蜷縮	
coy	a.靦腆的，忸怩的	
cozen	"v.欺騙, 哄騙"	
crab	n.蟹，螃蟹；v.抱怨，發脾氣	
crabbed	a.暴躁的	
crack	n.爆裂聲；裂縫；v.裂開；破解，破譯	
craft	n.行業；手藝	
cram	v.填塞，塞滿；臨時抱佛腳，為考試而學習	
cramp	n.鐵箍，夾子；v.把…箍緊	
cranky	a.怪癖的，任性的；不穩的	
crass	a.愚鈍的，粗糙的	
crate	n.簍，板條箱	
crater	n.火山口；彈坑	
cravat	n.領巾，領結	
craven	a.懦弱的，畏縮的	
craving	n.強烈的願望	
crayon	n.彩色臘筆、粉筆或其繪畫	
crease	n.折縫，皺痕	
credence	n.相信，信任	
credible	a.可信的，可靠的	
credit	n.賒購；信任；(電影)片頭字幕	
credulous	a.輕信的，易信的	
creek	n.小灣，小溪	
creep	v.匍匐前進；悄悄地移動	
crescendo	n.(音樂)漸強，高潮	
crest	n.山頂，浪尖；羽冠	
crestfallen	a.挫敗的，失望的	
cringe	v.畏縮；諂媚	
cringing	n./a.諂媚(的)，奉承(的)	
criteria	n.評判標準	
criterion	n.評判的標準，尺度	
critic	n.批評者	
critical	a.挑毛病的；關鍵的，危急的	
critique	n.批評性的分析	
croak	n.蛙鳴聲；v.發牢騷，抱怨	
crochet	n.鉤針織物；v.用鉤針編織	
crockery	n.陶器，瓦器	
cronyism	n.任人唯親；對好朋友的偏袒	
crook	v.使彎曲；n.鉤狀物	
cross	a.生氣的	
crouch	v.蹲伏，彎腰	
crown	v.加冕，使成王，居…之頂	
crucial	a.決定性的	
crudity	n.粗糙，生硬	
crumb	n.餅屑，麵包屑；碎裂的東西	
crumble	v.弄碎；崩毀	
crumple	v.弄皺；破裂	
crusade	n.維護理想、原則而進行的運動或鬥爭	
crust	n.硬的表面；(一片)麵包片；地殼	
crutch	n.拐杖；v.支撐	
crux	n.關鍵，癥結所在	
cryogenic	a.低溫的，製冷的；低溫學的	
cryptic	a.秘密的，神秘的	
cub	n.幼獸；年輕無經驗的人	
cubicle	n.大房間中隔出的小室	
cue	v.暗示，提示；n.暗示，提示	
cuisine	n.烹飪	
culinary	a.廚房的；烹調的	
culmination	n.頂點；結果	
culpable	a.有罪的，該受譴責的	
cult	n.宗派；崇拜	
cultivate	v.種植；向…討好	
cultivated	a.耕種的，栽植的；有修養的	
cumbersome	a.笨重的	
cumulus	n.積雲	
cunning	a.善於騙人的；靈巧的；n.欺詐行為	
cupidity	n.貪婪	
curator	n.(博物館等)館長	
curb	n.路緣，(街道的)鑲邊石；馬勒；v.控制	
curdle	v.使凝結，變稠	
curmudgeon	n.脾氣暴躁之人	
curriculum	n.(全部的)課程	
cursory	a.粗略的，草率的	
curt	a.(言詞、行為)簡略而草率的	
curtail	v.削減，縮短	
cushion	n.坐墊；v.緩衝	
custodian	n.管理員，監護人	
custody	n.監管，保管	
customary	a.合乎習俗的	
cuticle	n.表皮	
cutlery	n.(刀、叉、匙等)餐具	
cyclical	a.迴圈的	
cyclone	n.氣旋，颶風	
cylinder	n.圓柱	
cynic	n.犬儒主義者，憤世嫉俗者	
cypress	n.柏樹	
cytology	n.[生]細胞學	
dabble	v.涉足，淺賞	
daft	a.傻的	
dagger	n.短劍，匕首	
daguerreotype	n.(早期)銀版照相	
dainty	n.精美食品；a.嬌美的；挑剔的	
dally	v.閒蕩，嬉戲	
damp	v.減弱，制止振動；a.潮濕的	
damped	a.減震的，壓低(聲音)的	
dampen	v.(使)潮濕；使沮喪，潑涼水	
dandy	n.花花公子，好打扮的人	
dapper	a.整潔漂亮的；動作敏捷的	
dappled	a.有斑點的，斑駁的	
daredevil	a./n.膽大的(人)，冒失的(人)	
dart	n.飛鏢；v.急馳；投射	
daunt	v.使膽怯，使畏縮	
dawdle	v.閒蕩，虛度	
deactivate	v.使無效	
deaden	v.減低某物的力量或強度	
deadlock	n.相持不下，僵局	
deadpan	a./n.無表情的(臉)	
dealing	n.生意行為；作風	
dearth	n.缺乏，短缺	
debacle	n.解凍；崩潰	
debark	v.下船，下飛機，下車，卸載	
debase	v.貶低，貶損	
debate	n.正式的辯論，討論	
debilitate	v.使衰弱	
debouch	v.流出，進入(開闊地區)	
debrief	v.向…詢問情況，聽取彙報	
debris	n.廢墟，殘骸	
debunk	v.揭穿真相，暴露	
debut	n.初次登臺，初次露面	
decadence	n.衰落，頹廢	
deceit	n.欺騙，欺詐	
decency	n.正派，端莊	
decent	a.適當的，可接受的；得體的	
deception	n.欺騙手段	
decibel	n.分貝(音量的單位)	
deciduous	a.非永久的；短暫的；脫落的；落葉的	
decimate	v.毀掉大部分；大量殺死	
decipher	v.解開(疑團)；破譯(密碼)	
declaim	v.高談闊論	
declamation	n.雄辯，高調	
decline	v.拒絕；變弱，變小；n.消減	
decode	v.譯解(密碼)	
decompose	v.(使)腐爛	
decomposition	n.分解，腐爛，崩潰	
decorate	v.裝飾某事物	
decorum	n.禮節，禮貌	
decrepit	a.衰老的，破舊的	
decry	v.責難；貶低(價值)	
dedication	n.對某事業或目的的忠誠	
deduce	v.演繹，推斷	
deduct	v.減去，扣除；演繹	
deductive	a.推理的，演繹的	
deed	n.行為；(土地或建築物的)轉讓契約、證書	
deface	v.損壞	
default	v./n.拖債；未履行的責任	
defeatist	n.失敗主義者	
defect	n.缺點，瑕疵；v.變節，脫黨	
defendant	n.被告	
defense	n.防禦，防護	
defer	v.推延；聽從	
deference	n.敬意，尊重	
deferential	a.順從的，恭順的	
defiance	n.挑戰，違抗，反抗	
deficiency	n.缺陷；不足	
deficit	n.不足，赤字	
defile	v.弄汙，弄髒；n.(山間)小道	
defined	a.定義的；清晰的	
definite	a.清楚的，明確的	
definition	n.(輪廓等)清晰；定義	
definitive	a.明確的，有權威的	
deflated	a.灰心喪氣的	
deflect	v.偏離，轉向	
defoliator	n.落葉劑	
deforestation	n.採伐森林	
defraud	v.欺騙某人	
deft	a.靈巧的，熟練的	
defuse	v.從(爆破裝置)中卸載引信；緩和緊張狀態或危急局面	
defy	v.違抗，藐視	
degradation	n.降低身份，受辱	
dehydrate	v.除去水分，脫水	
deify	v.奉為神；崇拜	
deign	v.屈尊，惠允(做某事)	
dejected	a.沮喪的，失望的	
delectable	a.賞心悅目的	
delegate	n.代表；v.委派…為代表，授權	
deleterious	a.(對身心)有害的，有毒的	
deliberate	a.深思熟慮的，故意的；v.慎重考慮	
delicacy	n.細嫩；精緻，優雅	
delicate	a.嬌嫩的；精緻的，優美的	
delimit	v.定界，劃界	
delineate	v.描畫	
delinquency	n.失職，過失	
delinquent	a.疏忽職務的	
delirious	a.精神錯亂的	
delirium	n.精神錯亂	
delta	n.三角洲	
delude	v.欺騙，哄騙	
deluge	n.大洪水；暴雨	
delusion	n.欺騙，幻想	
delve	v.深入探究，鑽研	
demagogue	n.蠱惑民心的政客	
demand	v.要求，苛求	
demanding	a.苛刻的，過分要求的	
demean	v.貶抑，降低	
demise	n.死亡；財產轉讓	
demography	n.人口統計，人口學	
demolish	v.破壞；拆除	
demolition	n.破壞，毀壞	
demonstrate	v.證明，論證；示威	
demonstrative	a.證明性的；喜怒形於色的	
demoralize	v.使士氣低落	
demote	v.降級，降職	
demotic	a.民眾的，通俗的	
demur	v.表示異議，反對	
demystify	v.弄清楚	
den	n.獸穴，窩	
denigrate	v.污蔑，誹謗	
denim	n.粗斜紋棉布	
denizen	n.居民；外籍居民	
denomination	n.命名；(長度，幣值的)單位	
denote	v.表示；指示意義	
denouement	n.(小說的)結尾，結局	
denounce	v.指責	
dent	n.缺口，凹痕；v.弄凹	
denture	n.假牙	
denude	v.脫去；剝蝕；剝奪	
denunciation	n.譴責，斥責	
depict	v.描繪，描畫	
deplete	v.倒空；耗盡	
deplore	v.悲悼，哀歎	
deport	v.(將外國人、罪犯等)驅逐出境	
deportation	n.驅逐出境	
depose	v.免職；作證	
deposition	n.免職；沉積；作證	
depraved	a.墮落的，腐化的	
depravity	n.墮落，惡習	
deprecate	v.反對，輕視	
depreciate	v.輕視；貶值	
depressed	a.消沉的；凹陷的	
depression	n.憂愁，消沉；數量減少	
deprivation	n.剝奪；缺乏	
deputy	n.代表；副警長	
deracinate	v.根除，杜絕	
deranged	a.精神錯亂的，有精神病的	
derelict	a.荒廢的；怠忽職守的；n.被遺棄的人	
dereliction	n.遺棄，棄置	
deride	v.嘲弄，愚弄	
derivation	n.發展，起源；詞源	
derivative	a.派生的；無創意的	
dermatologist	n.皮膚病學家	
derogate	v.貶低，誹謗	
derogatory	a.不敬的，誹謗的	
descend	v.下來，下降	
descendant	n.後代，後裔	
descent	n.降落；侵襲；血統	
descry	v.遠遠看到，望見	
desecrate	v.玷辱，褻瀆	
desert	v.放棄，離棄	
deserted	a.荒蕪的，無人的	
deserter	n.背棄者，逃亡者	
desertion	n.離棄，遺棄	
desiccate	v.(使)完全乾涸，脫水	
designation	n.指定；名稱，稱呼	
designer	n.設計者，構思者	
desirable	a.值得要的	
desperate	a.不顧死活的，拼命的	
despicable	a.可鄙的，卑劣的	
despise	v.鄙視，藐視	
despondent	a.失望的，意氣消沉的	
despot	n.暴君	
despotic	a.專橫的，暴虐的	
despotism	n.專制，暴政	
destitution	n.匱乏，窮困	
desultory	a.不連貫的，散漫的	
detach	v.分離，分遣	
detached	a.分開的；超然的	
detain	v.拘留；使延遲	
detection	n.查出，探獲	
deter	v.威懾，嚇住；阻止	
detergent	a.淨化的；n.清潔劑	
deteriorate	v.(使)變壞，惡化	
deterioration	n.惡化，墮落	
determinant	n.決定因素；a.決定性的	
determination	n.決心；確定；預測	
detest	v.深惡，憎惡	
detonation	n.爆炸，爆炸聲	
detour	n.彎路；繞行之路	
detraction	n.貶低，誹謗	
detrimental	a.損害的，造成傷害的	
detritus	n.碎屑；廢墟	
devastate	v.摧毀，破壞	
deviant	a.越出常規的	
deviate	v.越軌，脫離	
deviation	n.背離	
devious	a.不正直的；彎曲的	
devise	v.發明，設計；圖謀；遺贈給	
devoid	a.空的，缺少的	
devoted	a.投入的，熱愛的	
devotee	n.愛好者	
devotional	a.獻身的，崇拜的	
devour	v.吞食；貪婪地享受	
devout	a.虔敬的；忠誠的，忠心的	
dexterity	n.純熟，靈巧	
dexterous	a.靈巧的，熟練的	
diabetes	n.糖尿病	
diabolical	a.惡毒的，狠毒的	
diagnose	v.判斷，診斷	
diagonal	a.對角的；n.對角線	
diagram	n.圖解，圖表	
dialect	n.方言	
diameter	n.直徑	
diaphanous	a.精緻的，透明的	
diatribe	n.(口頭或書面猛烈的)抨擊	
dictate	v.口述；命令	
didactic	a.教誨的；說教的	
die	n.金屬模子，印模	
diehard	n.頑固分子	
differentiate	v.辨別，區別	
diffident	a.缺乏自信的	
diffuse	v.散佈，(光等)漫射；a.漫射的，散漫的	
digestion	n.消化，吸收	
digit	n.手指，足趾；數字，數碼	
dignity	n.尊嚴，尊貴	
digress	v.離題	
digression	n.離題，題外話	
dilapidate	v.(使)荒廢，(使)毀壞	
dilapidated	a.破舊的，倒塌的	
dilate	v.(身體某部位)張大，擴大	
dilatory	a.慢吞吞的，磨蹭的	
dilemma	n.困境，左右為難	
dilettante	n.半瓶醋，業餘愛好者	
diligence	n.勤勉，勤奮	
dilute	v.把(液體)弄稀，弄淡	
dim	v.使暗淡，使模糊	
dimension	n.維度，尺寸	
diminution	n.減少，縮減	
dimple	n.酒窩，笑靨	
din	n.喧鬧聲，嘈雜聲	
dingy	a.骯髒的；褪色的	
diplomatic	a.外交的；圓滑的	
dire	a.可怕的	
dirge	n.哀歌	
disabuse	v.打消(某人的)錯誤念頭；糾正	
disaffect	v.使不滿；使不忠	
disagreeable	a.討厭的；乖戾的	
disarm	v.使…解除武器；使…緩和	
disarray	n.混亂，漫無秩序	
disaster	n.災難，大不幸	
disbar	v.取消律師資格	
disburse	v.支付，支出	
discard	v.扔掉，拋棄	
discern	v.(費勁)識別，看出	
discernible	a.可識別的，依稀可辨的	
discerning	a.識別力強的	
discharge	v.流出；釋放；解雇；履行義務	
disciple	n.信徒，弟子	
discipline	v.訓練，訓導；n.紀律；懲罰，處分	
disclaim	v.放棄權利；拒絕承認	
disclose	v.使某物顯露	
discography	n.唱片分類目錄；錄音音樂研究	
discombobulate	v.擾亂，使困惑	
discombobulated	a.擾亂的，打亂的	
discomfit	v.使懊惱；使難堪	
discomfited	a.困惑的，尷尬的	
discomfiture	n.狼狽，難堪	
discompose	v.使失態，慌張	
disconcert	v.使…尷尬	
discord	n.不和，紛爭	
discount	n.折扣	
discourse	n.演講，論述	
discredit	v.懷疑；n.喪失名譽	
discreet	a.言行謹慎的	
discrepancy	n.不同，矛盾	
discrete	a.個別的；不連續的	
discretion	n.謹慎，審慎	
discretionary	a.自由決定的	
discriminate	v.區分	
discriminatory	a.歧視的，差別待遇的	
discursive	a.散漫的，無層次的	
disdain	n./v.輕視，鄙視	
disembodied	a.無實體的，空洞的	
disenchant	v.對…不再抱幻想，使清醒	
disengage	v.脫離，解開	
disentangle	v.解決，解脫，解開，澄清	
disfigure	v.毀容	
disgorge	v.嘔出；(水)流走	
disgruntle	v.使不滿意	
disguise	v.假扮；掩飾	
disgust	n.反感，厭惡	
disillusion	v.夢想破滅，醒悟	
disinfect	v.殺菌，消毒	
disinfectant	n.消毒劑	
disinter	v.挖出，挖掘	
disinterested	a.公正的，客觀的	
disjunction	n.分離，分裂	
disjunctive	a.分離的，相反的	
dislocate	v.使脫臼；把…弄亂	
dislodge	v.逐出，取出	
dismal	a.使人悲傷的，陰沉的	
dismantle	v.拆除	
dismay	n.沮喪，氣餒；v.使氣餒	
disparage	v.貶抑，輕蔑	
disparate	a.迥然不同的	
disparity	n.不同，差異	
dispassionate	a.平心靜氣的	
dispatch	v.派遣；一下子做完；吃完；n.迅速	
dispel	v.驅散，消除	
dispensable	a.不必要的，可有可無的	
dispense	v.分配，分發	
disperse	v.消散，驅散	
displace	v.換置；使某人某物離開原位	
disposable	a.一次性使用的；可動用的	
disposal	n.清除，處理	
dispose	v.使傾向；處理掉	
disposed	a.願意的，想幹的	
disposition	n.處理；天性，氣質	
disproof	n.反證，反駁	
disprove	v.證明…有誤	
dispute	v.爭論	
disregard	v./n.疏忽，漠視	
disrepute	n.名聲不好	
disrupt	v.弄亂，擾亂	
disruptive	a.製造混亂的	
dissect	v.解剖	
dissemble	v.隱藏，掩飾(感受、意圖)	
disseminate	v.散佈，傳播	
dissent	v.不同意，持異議	
dissertation	n.專題論文	
dissident	n.唱反調者	
dissimulate	v.隱藏，掩飾	
dissipate	v.(使)驅散；浪費	
dissociation	n.分離，脫離關係	
dissolute	a.放蕩的，無節制的	
dissolve	v.使固體溶解	
dissonant	a.不和諧的，不一致的	
dissuade	v.勸阻，阻止	
distant	a.疏遠的，冷淡的	
distend	v.(使)膨脹，脹大	
distension	n.膨脹	
distill	v.蒸餾	
distinct	a.清楚的，明顯的	
distinction	n.區別，差別；知名	
distinctive	a.出眾的，有特色的	
distinguished	a.著名的，卓越的	
distort	v.扭曲，弄歪	
distract	v.分心，轉移；使發狂，困擾	
distracted	a.心煩意亂的，精神不集中的	
distraught	a.心神狂亂的	
distress	n.痛苦，悲痛	
distribute	v.分發，分配某事物	
district	n.地區，行政區，（美國各州的）眾議院選區	
ditty	n.小曲，小調	
diurnal	a.白晝的，白天的	
diva	n.歌劇中的首席女主角	
diver	n.潛水夫	
diverge	v.分歧，分開	
divergent	a.分叉的，岔開的，背道而馳的	
diverse	a.不同的；多樣的	
diversity	n.多樣，千變萬化	
divert	v.使某事物轉向；使娛樂	
divest	v.卸下盛裝；剝奪	
divestiture	n.脫衣，卸下裝飾；剝奪財產；取消稱號	
divine	v.推測，預言	
divulge	v.洩露，透露	
docile	a.馴服的，聽話的	
doctrinaire	n.空論家；a.教條的，迂腐的	
doctrine	n.教義，主義；學說	
document	v.為…提供書面證明	
dodder	v.蹣跚，搖擺	
dodge	v.閃開，躲避	
doff	v.脫掉	
dogged	a.頑強的	
doggerel	n.歪詩，打油詩	
dogma	n.教條，信條	
dogmatism	n.教條主義，武斷	
doldrums	n.赤道無風帶；情緒低落	
doleful	a.憂愁的，消沉的	
dolorous	a.悲哀的，憂愁的	
dolt	n.傻瓜	
domain	n.領土；領域	
dome	n.圓頂屋	
domesticate	v.馴養	
domicile	n.住處，住所	
dominant	a.顯性的，優勢的	
dominate	v.控制，支配	
domination	n.控制，支配，管轄	
donate	v.捐贈，贈送	
donor	n.捐贈者，贈送者；獻血者	
doodle	v.胡亂畫；混時間	
dormancy	n.休眠狀態	
dormant	a.冬眠的；靜止的	
dorsal	a.背部的	
dose	n.劑量，一劑	
dossier	n.卷宗，檔案	
dote	v.溺愛；昏聵	
doting	a.溺愛的	
dour	a.嚴厲的，臉色陰沉的	
douse	v.把…浸入水中；熄滅	
down	n.絨毛；汗毛	
downplay	v.貶低，不予重視	
downpour	n.暴雨	
down-to-earth	n.腳踏實地的，實際的	4:7]
doyen	n.老前輩	
drab	a.枯黃色的；無聊的	
draconian	a.嚴厲的，嚴酷的	
draft	n.草稿，草案；匯票	
draftsmanship	n.起草術，製圖術	
drain	v.排出溝外；喝光	
drainage	n.排水；污水	
drastic	a.猛烈的，激烈的	
drawbridge	n.吊撟	
drawl	v./n.慢吞吞地說話（態度）	
dreary	a.沉悶的，乏味的	
dregs	n.糟粕，沉澱廢物	
drench	v.使濕透	
drenched	a.濕透的	
drill	n.鑽；鑽床	
drivel	n./v.說廢話	
drizzle	v.下毛毛雨；n.毛毛雨	
drizzly	a.毛毛細雨的	
droll	a.古怪的，好笑的	
drone	v.嗡嗡地響，單調地說；n.單調的低音	
droop	v.低垂；沮喪，萎靡	
droplet	n.小水滴	
dross	n.浮渣；糟粕	
drought	n.乾旱；乾旱時期	
drove	n.畜群；人群	
drudgery	n.苦工，苦活	
dual	a.雙重的	
dubious	a.可疑的；名聲不大好的	
duckling	n.雛鴨，小鴨	
duct	n.管道，槽	
duel	n.決鬥	
duet	n.二重唱	
dull	a.不鮮明的；遲鈍的；v.變遲鈍	
dummy	n.人體模型，假人	
dune	n.沙丘	
dupe	n.易上當的人	
duplicitous	a.搞兩面派的，奸詐的	
duplicity	n.欺騙，口是心非	
duration	n.持續的時間	
duress	n.脅迫	
dutiful	a.恭敬順從的，盡職的	
dwarf	n.侏儒；矮小的植物；v.使變矮小	
dwelling	n.住處	
dwindle	v.變小	
dynamic	a.動態的；有活力的	
dynamo	n.發電機	
dysfunctional	a.功能失調的	
dyslexia	n.閱讀障礙	
dyspeptic	a.消化不良的；不高興的	
earnest	a.認真的	
earplug	n.耳塞	
earring	n.耳環，耳飾	
earshot	n.聽力所及範圍	
earsplitting	a.震耳欲聾的	
earthly	a.現世的，塵世的	
earthy	a.粗俗的，粗陋的	
easel	n.黑板，畫架	
eavesdrop	v.偷聽，竊聽	
ebb	v.退潮；衰退	
ebullience	n.興沖沖，亢奮	
eccentric	a.古怪的，反常的；n.古怪的人	
eclectic	a.折衷的，綜合性的	
eclecticism	n.折衷主義	
ecologist	n.生態學家，生態學者	
economical	a.經濟的，節約的	
ecstasy	n.狂喜；激情狀態	
ecstatic	a.狂喜的，心花怒放的	
eddy	n.漩渦，渦流	
edifice	n.宏偉的建築(如宮殿、教堂)	
edify	v.陶冶，啟發	
efface	v.擦掉，抹去	
effervesce	v.冒泡；熱情洋溢	
effete	a.無生產力；虛弱的	
efficacious	a.有效的	
efficacy	n.功效，有效性	
effluvia	n.氣味，惡臭；廢料	
effrontery	n.厚顏無恥	
effulgent	a.燦爛的	
egalitarian	a.主張人人平等的	
egocentric	a.利己的	
egotist	n.自私自利者	
egregious	a.(缺點等)過分的，驚人的	
egress	n.出去，出口	
elaborate	a.精緻的，複雜的；v.詳盡地說明，闡明	
elaboration	n.詳細的細節，詳盡闡述	
elated	a.得意洋洋的，振奮的	
elbow	n.肘	
elegy	n.哀歌，挽歌	
elementary	a.初級的	
elephantine	a.笨拙的，龐大的	
elevate	v.將…舉起	
elicit	v.引出，探出	
eligible	a.合格的	
eliminate	v.除去，淘汰	
elite	n.精華，中堅	
ellipsis	n.省略	
elliptical	a.橢圓的；晦澀的；省略的	
elm	n.榆樹	
elocution	n.演說術	
elongate	v.延長，伸長	
eloquence	n.雄辯，精彩演講	
elucidate	v.闡明，說明	
elude	v.逃避；搞不清	
elusive	a.難懂的	
emaciate	v.使…瘦弱；消瘦	
emaciation	n.消瘦，衰弱	
emanate	v.散發，發出，發源	
emancipate	v.解放，解除	
embargo	n.禁運令，封港令	
embarrass	v.使忸怩，使難堪	
embed	v.牢牢插入，嵌於	
embellish	v.裝飾，潤飾	
embezzlement	n.貪污，盜用	
emblematic	a.作為象徵的	
embody	v.(作品等)表達，體現	
embolden	v.鼓勵	
emboss	v.加浮雕花紋於，使凸出	
embrace	v.擁抱；包含	
embroider	v.刺繡，修飾	
emend	v.訂正，校訂	
emergency	n.緊急事件	
emigrate	v.自本國移居他國	
eminence	n.卓越，傑出	
eminent	a.著名的，顯著的	
emissary	n.密使；特使	
emit	v.放射(光、熱、味等)	
emollient	n.潤膚劑	
emote	v.激動地表達感情	
empathy	n.心意相通，(感情等)融為一體	
emphatic	a.重視的，強調的	
empirical	a.經驗的，實證的	
empiricism	n.經驗主義	
empower	v.授權給某人採取行動	
empyreal	a.天空的	
emulate	v.努力趕上或超越	
emulsify	v.使乳化	
enact	v.制定(法律)；扮演(角色)	
enamel	n.琺瑯，瓷釉	
enamored	a.珍愛的，喜愛的	
encapsulate	v.裝入膠囊；壓縮	
enchant	v.使迷醉；施魔法於	
enclosure	n.圈地，圍占	
encomiast	n.讚美者	
encomium	n.讚頌，頌辭	
encompass	v.包圍，圍繞	
encounter	v.遭遇	
encroach	v.侵佔，蠶食	
encumber	v.妨害，阻礙	
encyclopedia	n.百科全書	
endearing	a.討人喜歡的	
endemic	a.地方性的	
endorse	v.背書；贊同	
endow	v.資助，捐助	
endure	v.忍受，忍耐	
enduring	a.持續的	
enervate	v.使虛弱，使無力	
enfeeble	v.使衰弱	
enfetter	v.給…上腳鐐；束縛，使受制於	
enflame	v.使憤怒或激動	
engaged	a.忙碌的，使用中的	
engaging	a.迷人的，美麗動人的	
engender	v.產生，引起	
engrave	v.在(硬物)上雕刻	
engross	v.全神貫注於	
engulf	v.吞噬	
enhance	v.提高，增加，改善	
enjoin	v.命令，吩咐	
enlighten	v.啟發，開導，教導，授予…知識	
enlightening	a.有啟迪作用的；使人領悟的	
enlist	v.(使)入伍從軍，徵募	
enliven	v.使…更活躍	
enmesh	v.通常被動)絆住，陷入網	
enmity	n.敵意，仇恨	
ennui	n.倦怠，無聊；v.使無聊	
enormity	n.極惡；暴行；巨大	
enormous	a.極大的，巨大的	
enrage	v.激怒，觸怒	
enrapture	v.使狂喜，使高興	
ensconce	v.安置，安坐	
ensemble	n.全體；大合唱	
ensign	n.艦旗(船上表示所屬國家的旗幟)	
ensue	v.繼而發生	
ensure	v.確保，擔保	
entail	v.需要，需求，必須	
entangle	v.使糾纏，捲入	
enterprise	n.公司，事業單位；進取心	
enthralling	a.迷人的，吸引人的	
entice	v.慫恿，引誘	
entirety	n.整體，全面	
entitle	v.使有權(做某事)	
entity	n.實體，統一體	
entrance	v.使出神，使入迷	
entrancing	a.使人入神的	
entreat	v.懇求	
entreaty	n.懇求，哀求	
entr?e	n.正餐前的開胃菜；獲准進入的權利	
entrepreneur	n.企業家，創業人	
entrust	v.委託；託付	
entry	n.條目；登錄；報關手續；入口	
enumerate	v.列舉，枚舉	
enunciate	v.發音；(清楚地)表達	
environ	v.包圍，圍繞	
envision	v.想像，預想	
enzyme	n.酵素，?	
epaulet	n.肩章，肩飾	
ephemeral	a.朝生暮死的；生命短暫的	
epic	n.敘事詩，史詩；a.英雄的；大規模的	
epicure	n.美食家	
epidemic	a.傳染性的，流行性的	
epidermis	n.表皮，外皮	
epigram	n.諷刺短句，警句	
epilogue	n.收場白；尾聲	
episodic	a.偶然發生的，分散性的	
epitaph	n.墓誌銘	
epithet	n.(貶低人的)短語或形容詞	
epitome	n.典型；梗概	
epitomize	v.概括，摘要	
epoch	n.紀元；重大的事件	
equable	a.穩定的，不變的；(脾氣)溫和的	
equanimity	n.鎮定，沉著	
equate	v.認為…相等或相仿	
equation	n.等式；等同，相等	
equator	n.赤道	
equilibrium	n.平衡	
equine	a.馬的，似馬的	
equity	n.公平，公正	
equivalent	a.相等的，等值的	
equivocate	v.模棱兩可地說，支吾其詞，說謊	
equivocation	n.模棱兩可的話，含糊話	
eradicate	v.根除；撲滅	
erase	v.擦掉，抹去	
erasure	n.擦掉，擦痕	
erect	a.豎立的，筆直的，直立的	
err	v.犯錯誤，出錯	
errand	n.差使；差事	
erratic	a.反復無常的；古怪的	
ersatz	a.代用的，假的	
erstwhile	a.從前的，過去的	
erudite	a.博學的，飽學的	
erupt	v.爆發；噴出(熔岩、水、氣體、泥漿等)	
escalate	v.(戰爭等)升級；擴大，上升	
escalation	n.逐步上升，逐步增強	
escapism	n.逃避現實(的習氣)	
eschew	v.避開，戒絕	
esophagus	n.食道，食管	
esoteric	a.秘傳的；神秘的	
espionage	n.間諜活動	
espousal	n.擁護，支持	
espouse	v.支持，擁護	
espy	v.(從遠處等)突然看到	
essential	a.本質的；n.要素，實質	
estimable	a.值得尊敬的；可估計的	
estranged	a.疏遠的，分開的，分離的	
etch	v.蝕刻)；銘記	
etching	n.蝕刻術；蝕刻板畫	
eternal	a.永久的，永恆的	
ethereal	a.太空；輕巧的	
ethics	n.倫理學；道德規範	
ethnic	a.種族的	
ethnology	n.人種學，人類文化學	
ethos	n.(個人、團體或民族)道德風貌，思潮，信仰	
etiquette	n.禮儀；禮節	
etymology	n.語源學	
eucalyptus	n.桉樹	
eulogistic	a.頌揚的，歌功頌德的	
eulogize	v.稱讚，頌揚	
eulogy	n.頌詞，頌文	
euphemism	n.婉言，委婉的說法	
euphonious	a.悅耳的	
euphoria	n.幸福愉快感	
evacuate	v.撤退；撤離	
evade	v.逃避；規避	
evaluation	n.評價，評估	
evanescent	a.迅速消失的，短暫的	
evaporate	v.(使某物)蒸發掉	
evasion	n.躲避，藉口	
evasive	a.迥避的，逃避的，託辭的	
even	a.平的	
evenhanded	a.公平的，不偏不倚的	
evict	v.(依法)驅逐	
eviction	n.(對房客或佃戶的)驅逐	
evince	v.表明，表示	
evocative	a.喚起的，激起的	
evoke	v.引起；喚起	
evolve	v.使逐漸形成，進化	
ewe	n.母羊	
ewer	n.大口水罐	
exacerbate	v.加重，惡化	
exact	a.精確的；v.強求，強索付款	
exacting	a.苛求的；要求嚴格的	
exactitude	n.極端的正確性或精確性	
exaggerate	v.誇張；誇大	
exaggeration	n.誇張	
exalt	v.(高度)讚揚，歌頌	
exaltation	n.(成功帶來的)得意，高興	
exasperate	v.激怒，使惱怒	
excavate	v.挖掘；挖出	
exceed	v.超過；超出	
excel	v.善於，擅長於	
exceptional	a.特別(好)的	
excess	n.過分，過度	
excise	v.切除，刪去	
excitability	n.易興奮性，易激動性	
exclaim	v.驚叫，呼喊	
exclamation	n.驚歎詞，驚呼	
exclude	v.排斥；排除	
exclusive	a.(人)孤僻的；(物)專用的	
excoriate	v.撕去皮；嚴厲批評	
excrete	v.排泄，分泌	
exculpate	v.開脫，申明無罪	
excursion	n.短途旅遊	
excursive	a.離題的，隨意的	
execrable	a.極壞的	
execrate	v.憎惡；咒?	
execute	v.執行，履行；將某人處死	
exemplary	a.可作楷模的	
exemplify	v.是…的典型	
exempt	a.被免除的；v.使免除	
exert	v.運用(力量等)	
exhale	v.呼出(氣)	
exhaust	n.(機器排出的)廢氣，蒸氣；v.使非常疲倦	
exhaustive	a.徹底的，無遺漏的	
exhilarate	v.使高興	
exhilaration	n.高興，活躍	
exhort	v.力勸，勉勵	
exigent	a.需要立即採取行動的	
existential	a.有關存在的，存在主義的	
exodus	n.大批離去，成群外出	
exonerate	v.免除責任；確定無罪	
exorbitant	a.過分的，過度的	
exorcise	v.驅魔；去除(壞念頭等)	
exotic	a.珍奇的；來自異國的	
expand	v.擴大，膨脹	
expansive	a.(指人)健談的，開朗的；可擴大的，可伸展的	
expediency	n.方便；權宜之計	
expedient	n.權宜之計，臨時手段；a.(指行動)有用的	
expeditious	a.迅速的，敏捷的	
expel	v.排出；開除	
expend	v.花費；用光	
expenditure	n.消耗，支出	
expertise	n.專門技術，專業知識	
expiate	v.贖罪，補償	
expiration	n.期滿，終止	
expire	v.期滿；去世	
explicate	v.詳細解說	
explicit	a.清楚明確的	
exploit	v.剝削；開發利用；n.英勇行為	
explosive	n.炸藥；a.爆炸性的；使人衝動的	
exponent	n.說明者，支持者；指數	
exponentially	adv.指數地；迅速增長地	
exposition	n.闡釋；博覽會	
expository	a.說明的	
expostulate	v.(對人或行為進行)抗議，告誡	
exposure	n.暴露，顯露，曝光	
expound	v.解釋；闡述	
expressly	adv.清楚地；特意地	
expunge	v.刪除	
expurgate	v.刪除；使純潔	
exquisite	a.精緻的；近乎完美的	
extant	a.現存的，傳世的	
extemporaneous	a.即席的，沒有準備的	
extemporize	v.即席演說	
extend	v.延展，延長	
extenuate	v.掩飾(罪行)，減輕罪過	
exterminate	v.消滅，滅絕	
externalize	v.使…表面化	
extinct	a.絕種的，不存在的	
extinction	n.熄滅；消滅	
extinguish	v.使…熄滅；使…不復存在	
extirpation	n.根除，剷除	
extol	v.讚美	
extort	v.強索，敲詐	
extract	v.拔出；強索	
extraneous	a.外來的；無關的	
extrapolate	v.預測，推測	
extravagance	n.奢侈，揮霍	
extremist	n.極端主義者	
extricable	a.可解救的，能脫險的	
extricate	v.拯救，救出	
extrovert	n.性格外向者	
exuberance	n.愉快；茁壯	
exuberant	a.(人)充滿活力的(植物)茂盛的	
exude	v.使慢慢流出；四溢	
exult	v.歡騰，喜悅	
fabric	n.紡織品；結構	
fabricate	v.捏造；製造	
facade	n. 建築物的正面；(虛偽)外表	
facet	n.(寶石等的)小平面；側面	
facetious	a.輕浮的，好開玩笑的	
facile	a.容易做的；膚淺的	
facilitate	v.使容易，促進	
facilities	n.(使事情便利的)設備、工具	
faction	n.派系；派系鬥爭	
factorable	a.能分解成因數的	
factotum	n.雜役，聽差	
factual	a.真實的，事實的	
faculty	n.全體教員；官能	
fad	n.(流行一時的)狂熱，時尚	
faddish	a.流行一時的，時尚的	
fade	v.褪色，消失，凋謝	
falcon	n.獵鷹；隼	
fallacious	a.欺騙的；謬誤的	
fallacy	n.謬誤，錯誤	
fallibility	n.易於出錯，出錯性	
fallible	a.會犯錯的，易犯錯的	
fallow	n.休耕地；a.(土地)休耕的	
falsehood	n.謊言	
falter	v.搖晃，蹣跚；支吾地說	
familiarity	n.精通；親近；不拘禮儀	
famine	n.饑荒	
famish	v.使饑餓	
fanatic	n.狂熱者	
fang	n.(毒蛇的)尖牙	
fantasy	n.想像，幻想	
farce	n.鬧劇；荒謬胡鬧	
farewell	interj.再會，再見；n.辭行，告別	
far-reaching	a.影響深遠的	
fast	n.絕食，齋戒；adv.很快地，緊緊地	
fasten	v.使…固定(to fix sth. firmly)	
fastidious	a.難取悅的，挑剔的	
fastness	n.要塞，城堡	
fatal	a.致命的；災難性的	
fathom	n.英尋(量水深用，相當於1.83米)；v.徹底明白，瞭解	
fatigue	n.疲乏，勞累	
fatten	v.使長肥；使土壤肥沃；裝滿	
fatuity	n.愚蠢，愚昧	
fatuous	a.愚昧而不自知的	
faucet	n.水龍頭	
fault	n.錯誤；(地質學)斷層	
faultfinder	n.喜歡挑剔的人	
favorable	a.有利的；贊成的	
fawn	n.未滿周歲的小鹿；v.巴結，奉承	
faze	v.使…狼狽，折磨	
feasible	a.可行的，可能的	
feat	n.功績，壯舉	
feature	n.特色，特點，特徵	
feckless	a.無目標無計畫的	
fecundity	n.多產，富饒；繁殖力，生殖力	
feeble	a.虛弱的	
feedback	n.(資訊的)回饋	
feign	v.假裝，偽裝	
feigned	a.假裝的；不真誠的	
feint	v./n.佯攻，佯擊	
felicitous	a.(話語等)適當的，得體的	
fell	n.獸皮；v.砍伐；a.兇猛的，可怕的	
felon	n.重罪犯	
felony	n.重罪	
feminist	n.女權運動者	
fender	n.擋泥板；護舷的墊子等	
feral	a.兇猛的，野的	
ferment	v./n.(使)發酵；騷動	
fermentation	n.發酵	
fern	n.羊齒植物，蕨	
ferret	n.雪貂；v.用雪貂獵取；搜尋	
ferrous	a.含鐵的	
fertile	a.多產的；肥沃的	
fertilize	v.受精，受粉；施肥	
fertilizer	n.肥料，化肥	
fervid	a.熾熱的，熱情的	
fervor	n.熱誠，熱心	
fester	v.(指傷口)潰爛，化膿	
festive	a.歡樂的	
fetid	a.有惡臭的	
fetter	n./v.(帶)腳鐐；束縛	
fetus	n.胎兒	
feud	n.宿怨，不和	
fiasco	n.大失敗，慘敗	
fiat	n.命令	
fickle	a.(愛情或友誼上)易變的，不堅定的	
fictitious	a.假的；虛構的	
fidget	v.坐立不安；n.煩躁之人	
fig	n.無花果；一點兒	
figment	n.虛構的東西	
figurative	a.比喻的，借喻的	
figurehead	n.名義領袖；傀儡	
figurine	n.小塑像，小雕像	
file	n.銼刀；v.銼平	
filibuster	v./n.妨礙議事，阻撓	
filigree	n.金銀絲做的工藝品	
filings	n.銼屑	
filly	n.小母馬	
filter	n.濾紙；v.過濾	
filth	n.骯髒；粗語	
finale	n.最後，最終；樂曲的最後部分	
finesse	n.技巧；計謀；手段	
finicky	a.苛求的，過分講究的	
finite	a.有限的	
firearm	n.(可?式)槍支	
firefly	n.螢火蟲	
fiscal	a.國庫的，財政的	
fissure	n.裂縫，裂隙	
fixate	v.使固定，使不變；注視，凝視	
flaccid	a.鬆弛的；軟弱的	
flag	v.減弱，衰退；枯萎	
flagging	a.下垂的；衰弱的	
flaggy	a.枯萎的；鬆軟無力的	
flagrant	a.臭的，惡名昭彰的	
flail	n.連枷(打穀工具)；v.打，打擊	
flak	n.高射炮；指責	
flamboyant	a.豔麗的，炫耀的	
flammable	a.易燃的	
flange	n.(火車車輪的)凸緣，輪緣	
flare	n./v.(火焰)搖曳，閃耀	
flask	n.燒瓶，細頸瓶	
flatcar	n.平臺型鐵路貨車	
flatten	v.變平；徹底打敗某人	
flatter	v.恭維，奉承	
flaunt	v.炫耀；張揚	
flaunty	a.炫耀的，張揚的	
flaw	n.瑕疵；v.生裂縫；有瑕疵	
flax	n.亞麻	
fledge	v.小鳥長飛羽，變得羽毛豐滿	
fledgling	n.正在學習飛行的幼鳥；無經驗的人	
fleeting	a.短暫的，飛逝的	
flexible	a.易彎曲的，靈活的	
flight	n.飛行，飛翔；逃跑	
flimsy	a.輕而薄的；脆弱的	
flinch	v.畏縮，退縮	
flint	n.打火石，燧石	
flip	v.用指輕彈；蹦跳；a.無禮的	
flippant	a.無禮的；輕率的	
flirt	v.挑逗，調戲	
flit	v.掠過，迅速飛過	
flock	n.羊群；鳥群	
floodgate	n.(水閘的)閘門	
flora	n.(某地區或時代的)植物群	
florid	a.華麗的；(臉)紅潤的	
flounder	v.掙扎；艱苦地移動；n.比目魚	
flourish	v.昌盛，興旺；活躍而有影響	
flout	v.蔑視，違抗	
fluctuate	v.波動；變化	
fluffy	a.有絨毛的；空洞的	
fluke	n.僥倖；意想不到的事	
fluorescent	a.螢光的，發光的	
flush	n./v.臉紅；奔流；沖洗	
flustered	a.慌張的	
flutter	v.拍翅	
fluvial	a.河流的，生長在河中的	
flux	n.不斷的變動，動盪不定	
foible	n.小缺點，小毛病	
foil	n.鈍劍；箔，錫箔紙	
fold	n.羊欄，畜欄；v.折疊	
folder	n.資料夾，紙夾	
foliage	n.葉子(總稱)	
folklore	n.民間傳說；民俗學	
folly	n.愚蠢；愚蠢的行為，思想或做法	
foment	v.煽動，助長(壞事)	
foodstuff	n.食料，食品	
foolproof	a.容易懂的，簡易而不會誤用的	
foppish	a.浮華的，俗麗的	
forage	n.(牛馬的)飼料，糧草；v.搜尋，翻尋	
forager	n.強征(糧食)者，搶劫者；糧草徵發員；成散開橫隊的騎兵	
forbearance	n.自製，忍耐	
forbid	v.不許，禁止；妨礙，阻止	
forbidding	a.(表情)冷峻的；形勢險惡的	
ford	n.淺灘，水淺可涉處；v.涉水	
forebode	v.預感，凶兆	
forecast	v.預報，預測；n.預測	
foreknowledge	n.預知	
forerunner	n.預兆，前兆；先驅	
foreshadow	v.預示	
foresight	n.遠見，深謀遠慮	
forestall	v.先發制人，預先阻止	
forestry	n.森林學；林產；林地	
forfeit	v.喪失，被罰沒收；n.喪失物	
forge	n.鐵匠鋪；v.錘煉；偽造	
forger	n.偽造者；打鐵匠	
forgery	n.偽造(物)	
forgo	v.放棄，拋棄	
formality	n.遵循的規範；拘泥形式；正式	
formation	n.組織，形成；(軍隊)編隊	
formidable	a.可怕的；困難的	
formula	n.分子式；公式；套語，慣用語	
forsake	v.遺棄，放棄	
forte	n.長處，擅長；a.(音樂)強音的	
forthright	a.直率的	
fortify	v.加強防衛	
fortitude	n.堅毅，堅韌不拔	
fortuitous	a.偶然的，意外的；幸運的	
forum	n.辯論的場所，講壇	
forward	a.過激的，莽撞的	
fosse	n.護城河	
fossilize	v.使…成為化石；使…過時	
foster	v.培養，鼓勵；領養	
foul	a.惡臭的；邪惡的；v.弄髒；n.(體育等)犯規	
founder	v.(船)沉沒；(計畫)失敗	
four-poster	n.有四柱的床	
foyer	n.門廳，休息室	
fracas	n.喧嚷，吵鬧	
fraction	n.碎片；小部分	
fractious	a.(脾氣)易怒的，好爭吵的	
fracture	n.骨折；折斷；裂口	
fragile	a.易碎的，易壞的	
fragment	n.碎片；分裂	
fragrance	n.香料；香味	
fragrant	a.芳香的；愉快的	
frail	a.脆弱的；不堅實的	
frantic	a.瘋狂的，狂亂的	
fraud	n.欺詐，欺騙；騙子	
fraudulent	a.欺騙的，不誠實的	
fraught	a.充滿…的	
freckle	n.雀斑，斑點	
freelancer	n.自由職業者	
freight	n.貨物；v.裝貨於(船等)	
frenetic	a.狂亂的，發狂的	
frenzy	n.極度激動的狀態，狂暴	
frequency	n.頻率	
frequent	v.時常來訪；a.慣常的	
fresco	n.壁畫	
fret	n./v.(使)煩躁，焦慮	
friable	a.易碎的	
friction	n.摩擦；矛盾，衝突	
frieze	n.(在牆頂與天花板間起裝飾作用的)橫條，飾帶	
frigid	a.寒冷的；死板的	
frigidity	n.寒冷；冷淡	
fringe	n.(窗簾等)須邊；邊緣	
frisky	a.活潑的，快活的	
frivolous	a.輕薄的，輕佻的	
frond	n.羊齒、棕櫚等的葉子	
frothy	a.起泡的；空洞的	
frugal	a.節約的，節儉的	
fruition	n.實現，完成	
frustrate	v.挫折，使沮喪	
fulcrum	n.杠杆支點，支柱	
fulfil	v.履行；滿足，符合	
full-blown	a.(鮮花)盛開的	
full-bodied	a.(味道等)濃郁而強烈的	
full-fledged	a.羽毛豐滿的；成熟的	
fulminate	v.猛烈抨擊，嚴厲譴責	
fulsome	a.虛情假意的；充足的	
fumble	v.摸索，笨拙搜尋；弄亂，搞糟	
fume	v./n.憤怒；冒煙	
fumigate	v.以煙熏消毒	
functional	a.起作用的，能運轉的；實用的	
functionary	n.小官，低級公務員	
fundamental	a.最根本的，基本的；十分重要的	
fungi	n.菌類，蘑菇	
fungicide	n.殺真菌劑	
furnace	n.鍋爐	
furor	n.轟動；盛怒	
furrow	n.犁溝；皺紋	
furtive	a. 偷偷的，秘密的	
fusillade	n./v. (槍炮)齊射，連發	
fusion	n.熔合；聚變	
fuss	n.大驚小怪	
fussy	a.愛挑剔的	
fusty	a.陳腐的，黴臭的	
futile	a.無效的，無用的;（人）沒出息的；瑣細的	
futility	n.無用，無益	
gadfly	n.虻，牛虻；討厭的人	
gadget	n.小工具，小機械	
gaffe	n.(社交上令人不快的)失言，失態	
gaggle	n.鵝群	
gainsay	v.否認	
gait	n.步法，步態	
galaxy	n.(銀河)星群；顯赫的人群	
gall	n.膽汁；怨恨	
gallant	a.勇敢的；(向女人)獻殷勤的	
galley	n.船上的廚房	
gallon	n.加侖	
galvanize	v.電鍍；通電；激勵	
gamble	v./n.賭博；孤注一擲	
gambol	n./v.雀躍；嬉戲	
gangway	n.(上下船的)跳板	
gape	v.裂開；目瞪口呆地凝視	
garble	v.曲解，竄改	
garbled	a.引起誤解的；竄改的	
gardenia	n.梔子花	
gargantuan	a.巨大的，龐大的	
gargoyle	n.(雕刻成怪獸狀的)滴水嘴；面貌醜惡的人	
garish	a.俗麗的，過於豔麗的	
garment	n.衣服	
garner	v.收藏，積累	
garnish	v.裝飾	
garrulity	n.嘮叨，饒舌	
garrulous	a.嘮叨的，多話的	
gaseous	a.似氣體的	
gash	n.深長的傷口，裂縫	
gasification	n.氣化	
gaucherie	n.笨拙	
gaudy	a.俗麗的	
gauge	n.標準規格；測量儀；v.測量	
gavel	n.(法官所用的)槌，小木槌	
gaze	v./n.凝視，注視	
gazetteer	n.地名詞典，地名表	
gear	n.齒輪；裝備；儀器	
gem	n.寶石，珠寶；精華	
gene	n.基因	
genealogy	n.家譜學	
generality	n.概述	
generalize	v.歸納	
generate	v.造成；產生	
generation	n.一代人；(產品類型的)代；產生，發生	
generator	n.發電機	
generic	a.種類的，類屬的	
generosity	n.慷慨，大方	
genesis	n.創始，起源	
genetic	a.遺傳的；起源的	
genetics	n.遺傳學	
genial	a.愉快的，脾氣好的	
genome	n.基因組，染色體組	
genre	n.(文藝的)類型	
genteel	a.上流社會的；裝作彬彬有禮的	
gentle	a.溫和的，慈祥的	
gentry	n.紳士，上等人	
genuine	a.真的；真誠的	
genus	n.(動植物的)屬	
geometrician	n.幾何學家	
germ	n.胚芽，芽孢；微生物，細菌	
germane	a.有密切關係的；貼切的	
germicide	n.殺菌劑	
germinate	v.發芽；發展	
gerontocracy	n.老人統治的政府	
gerontology	n.老人病學	
gerrymander	v.(為使某政黨在選舉中取得優勢)不公正地將(某地區)劃成選區	
gesture	n.姿勢，手勢，姿態	
geyser	n.天然熱噴泉	
gibe	n./v.嘲弄，譏笑	
giddy	a.輕浮的，不嚴肅的	
giggle	v.咯咯笑	
gild	v.鍍金；虛飾	
gimmick	n.吸引人的花招，噱頭	
ginger	n.薑；活力	
gingerly	adj./adv.小心的(地)；謹慎的(地)	
girder	n.大樑	
girth	n.腰身；周長	
gist	n.要點，要旨	
glacial	a.冰期的，冰河期的；寒冷的	
glade	n.林中的空地	
gladiator	n.角鬥士，與野獸搏鬥者	
glance	v./n.一瞥	
glare	v.發出眩目光芒；怒目而視	
glaze	v.裝玻璃於；上釉彩；n.釉	
glean	v.拾落穗；收集(材料等)	
glib	a.流利圓滑的，善辯的	
glide	v.滑行，滑動	
glimmer	v.發微光；n.搖曳的微光	
glisten	v.閃爍，閃耀	
glitch	n.小故障	
gloat	v.幸災樂禍地看，竊喜	
gloom	n.黑暗；憂鬱	
gloomy	a.陰暗的；沒有希望的；陰鬱的	
gloss	n.光澤；注解	
glossary	n.詞彙表；難詞表	
glossy	a.光澤的，光滑的	
glow	v./n.光亮，發熱；(臉)紅	
glower	v.怒目而視	
glowing	a.熱情讚揚的	
glucose	n.葡萄糖	
glut	v./n.過多；供過於求	
glutinous	a.粘的，膠狀的	
gluttonous	a.貪吃的，貪嘴的	
gnarled	a.(樹木)多節的；粗糙的	
gnaw	v.啃，咬	
goad	n.趕牛棒；v./n.刺激，激勵	
gobble	v.貪婪地吃，吞沒	
goblet	n.高腳酒杯	
goldbrick	v.逃避責任，偷懶	
gong	n.鑼	
goodwill	n.友好	
gorge	n.峽谷	
gorilla	n.大猩猩	
gospel	n.教義，信條	
gossamer	n.蛛絲；薄紗；a.輕而薄的	
gouge	n.半圓鑿；v.挖出；敲竹槓	
gourmand	n.嗜食者	
gourmet	n.美食家	
grace	n.優美	
gracious	a.大方的，和善的；奢華的	
gradation	n.漸變；階段，等級	
graduated	a.按等級(高度，困難等)分的	
graft	v./n.嫁接；貪污	
grain	n.穀物；小的硬粒	
grandeur	n.壯麗，偉大	
grandiose	a.宏偉的；誇大的	
grandstand	n.大看臺；v.嘩眾取寵	
granite	n.花崗石	
grant	v.同意給予	
graphic	a.圖表的；生動的	
graphite	n.石墨	
grasping	a.貪心的，貪婪的	
grate	v.發出“吱嘎”聲；磨碎；使人煩躁	
grateful	a.感激的	
gratification	n.滿足，喜悅	
gratify	v.使高興，使滿足	
grating	a.(聲音)刺耳的；惱人的	
gratitude	n.感激	
gratuitous	a.無緣無故的；免費的	
gratuity	n.賞錢，小費	
grave	a.嚴峻的；n.墓穴	
gravel	n.碎石，砂礫	
gravitational	a.萬有引力的	
gravity	n.嚴肅，正經	
graze	v.(動物)吃(地上長的)草；放牧	
grease	n.(煉出的)動物油脂；滑脂	
green	a.新鮮的，未成熟的，無經驗的	
greenhouse	n.花房，溫室	
gregarious	a.群居的；愛社交的	
gregariousness	n.群居；合群	
grenade	n.手榴彈	
grief	n.憂傷，悲傷	
grievance	n.委屈，抱怨	
grieve	v.使某人極為悲傷	
grievous	a.嚴重傷害的	
grill	v.烤；拷問；n.烤架	
grim	a.冷酷的，可怕的	
grimace	v./n.做鬼臉，面部歪扭	
grin	v.露齒而笑	
grind	n.枯燥乏味的工作；v.磨碎，碾碎	
gripe	v.抱怨	
gripping	a.緊緊抓住注意力的	
grisly	a.恐怖的，可怕的	
gristle	n.軟骨；肉中難吃的硬組織	
grit	n.沙粒；決心，勇氣；v.下定決心，咬緊牙關	
groan	v./n.呻吟，歎息	
groom	n.馬夫；新郎	
groove	n.凹線；(刻出的)線條；習慣	
grope	v.摸索，探索	
gross	a.總的；粗野的；n.整個，全部	
grotto	n.洞穴	
grouch	n.牢騷，不滿	
grounded	a.有理由的；adv.地面上	
group	v.使…集合；n.群，集	
grouse	n.松雞；v.牢騷，訴苦	
grove	n.小樹林，樹叢	
grovel	v.搖尾乞憐，奴顏婢膝	
grueling	a.繁重而累人的	
grumble	v.喃喃訴苦，發怨言	
guarantee	v.保證，擔保	
guffaw	n./v.哄笑，大笑	
guile	n.欺詐，狡猾	
guileless	a.厚道的，老實的	
guillotine	n.斷頭臺	
guilt	n.罪行；內疚	
guilty	a.有罪的	
guise	n.外觀，裝束	
gullible	a.易受騙的	
gully	n.雨水沖成的溝壑	
gulp	v.吞食，咽下	
gum	n.樹膠，橡皮	
guru	n.古魯(印度的宗教領袖)；(受尊敬的)教師或權威	
gush	v.湧出；滔滔不絕地說	
gusher	n.滔滔不絕的說話者；噴油井	
gust	n.陣風；一陣(情緒)	
gustation	n.品嘗；味覺	
gustatory	a.味覺的，品嘗的	
gutter	n.水槽；街溝	
guy	n.(鐵塔等的)支索，牽索	
guzzle	v.大吃大喝	
gyrate	a.旋轉的；v.旋轉	
habitat	n.自然環境，棲息地	
habituate	v.使習慣於	
hack	v.亂劈，亂砍；n.雇傭文人	
hackneyed	a.陳腐的，平常的	
hail	n.冰雹；v.致敬	
halcyon	a.平靜的；愉快的	
hale	a.健壯的，矍鑠的	
halfhearted	a.不認真的，不熱心的	
hallmark	n.(在金銀上的)純度印記；特徵	
hallow	v.把…視為神聖，尊敬	
hallowed	a.神聖的	
hallucination	n.幻覺，幻視	
halo	n.(日、月等)暈，神像之光環	
halting	a.躊躇的，吞吞吐吐的	
hammer	n.錘子，槌	
hamper	v.妨礙，阻撓；n.有蓋提籃	
handle	n.柄，把手；v.處理	
hangar	n.飛機庫	
hangdog	a.憂愁的；低賤的	
hankering	n.渴望	
haphazard	a.任意的	
harangue	n.長篇指責性演說	
harass	v.侵擾，煩憂	
harbinger	n.先驅，先兆	
harbor	n.港，避難所；v.包庇，隱匿	
harden	v.變硬，變堅強	
hardheaded	a.(商業上)現實的，精明的	
hardy	a.耐寒的；強壯的	
harmony	n.相符，一致；協調，勻稱	
harness	n.馬具；v.束以馬具；利用	
harp	n.豎琴；v.喋喋不休地說或寫	
harpsichord	n.鍵琴(鋼琴前身)	
harridan	n.兇惡的老婦，老巫婆	
harrow	n.耙；v.使痛苦	
harrowing	a.悲痛的，難受的	
harry	v.掠奪，襲擾，折磨	
harsh	a.嚴厲的；粗糙的；刺耳的	
harshly	adv.嚴酷地，無情地	
hasten	v.催促，促進	
hasty	a.急急忙忙的	
hatch	n.船艙蓋；v.孵化	
haughty	a.傲慢的，自大的	
haunt	v.常去；鬼魂出沒；(事情)縈繞心頭；n.常去的地方	
hauteur	n.傲慢	
haven	n.安息所，避難所	
havoc	n.大破壞，混亂	
hawk	n.隼，鷹	
hazard	n.危險	
hazardous	a.危險的	
headlong	adj./adv.輕率的(地)，迅猛的(地)	
headstrong	a.剛愎自用的	
headway	n.進步，進展	
heal	v.治癒	
hearken	v.傾聽	
hearten	v.鼓勵，激勵	
heartrending	a.令人心碎的	
heavy-handedness	n.笨拙，粗劣	
heckle	v.詰問，困擾	
hectic	a.興奮的；繁忙的	
hector	v.淩辱，威嚇	
hedge	n.樹籬；限制	
hedonist	n.享樂主義者	
heed	v.注意，留心；n.關心	
hegemony	n.霸權，領導權	
heinous	a.十惡不赦的	
heir	n.繼承人	
heirloom	n.傳家寶	
helmet	n.頭盔，鋼盔	
hem	v.包圍；n.袖邊，邊緣；interj.吞吞吐吐地說	
hemisphere	n.半球	
hemophilia	n.血友病，出血不止	
hemorrhage	n.出血(尤指大出血)	
hemostat	n.止血器；止血劑	
herbaceous	a.草本植物的	
herbicide	n.除草劑	
herbivorous	a.食草的	
herd	n.獸群；v.聚集	
hereditary	a.祖傳的，世襲的	
heresy	n.異端邪說	
heretic	n.異教徒	
heretical	a.異端邪說的	
hermetic	a.密封的；深奧的	
hermit	n.隱士，修道者	
herpetologist	n.爬行動物學家	
heterodox	a.異端的，非正統的	
heterogeneous	a.異類的，不同的	
hew	v.砍伐；遵守	
hexagon	n.六角形，六邊形	
hiatus	n.空隙，裂縫	
hibernate	v.冬眠，蟄伏	
hide	n.獸皮	
hidebound	a.頑固的，心胸狹窄的	
hideous	a.討厭的，醜惡的	
hie	v.疾走，催促	
hierarchy	n.階層；等級制度	
hieroglyph	n.象形文字，圖畫文字	
hieroglyphic	n.象形文字	
highbrow	n.自以為文化修養很高的人	
hike	v.高漲，上升；n.徒步旅行	
hilarious	a.充滿歡樂的；引起大笑的	
hinder	v.阻礙，妨礙	
hinge	n.鉸鏈；關鍵	
hirsute	a.多毛的	
hiss	v.作噓聲；(蛇等)發出嘶嘶聲	
histology	n.細胞組織學	
histrionic	a.演戲的；劇院的	
hitherto	adv.到目前為止	
hive	n.蜂房；忙碌之地	
hoard	v./n.貯藏，秘藏	
hoary	a.(頭髮)灰白的；古老的	
hoax	n./v.騙局，欺騙	
hodgepodge	n.混淆；雜菜	
hoe	n.鋤頭	
hoist	v.吊高，升起；n.起重機	
hold	n.(船)貨艙	
holster	n.手槍皮套	
homage	n.效忠，崇敬	
homeostasis	n.體內平衡	
homiletics	n.講道術，說教術	
homogeneity	n.同種，同質	
homogeneous	a.同類的，相似的	
homogenize	v.使均勻，使一致	
hone	n.磨刀石；v.磨刀	
honorarium	n.酬勞金，謝禮	
hoodwink	v.蒙混，欺騙	
hoof	n.(牛馬的)蹄	
hoop	n.(桶之)箍，鐵環	
horizontal	a.水準的	
hormone	n.荷爾蒙，激素	
horn	n.角，角質；喇叭	
horrific	a.可怕的	
hortative	a.激勵的	
horticulture	n.園藝學	
hospitable	a.豁達的	
hostile	a.敵對的，敵意的	
hostility	n.敵對，不友好，憎恨	
hovel	n.茅舍；骯髒的小屋	
hover	v.翱翔；(人)徘徊	
hub	n.軸心；中心	
hubris	n.過分自傲，目中無人	
huckster	n.叫賣小販，零售商	
hue	n.色彩，色澤	
hulk	n.廢船，船殼；笨重之人或物	
hull	n.外殼；莢；船身；v.剝去外殼	
humane	a.人道的，慈悲的	
humble	a.卑微的；v.使謙卑	
humdrum	a.單調的，乏味的	
humid	a.濕潤的	
humidity	n.濕度，濕氣	
humiliate	v.使屈辱	
humility	n.謙遜，謙恭	
humor	v.縱容，遷就	
hunch	n.直覺，預感	
hurdle	n.跳欄；障礙；v.克服(障礙)	
hurl	v.猛投；大聲叫?	
hurricane	n.颶風	
husband	v.妥善而又節約地管理；做…的丈夫	
husbandry	n.耕種，務農；節斂管理	
hush	v./n.肅靜，安靜	
husk	n.外殼；皮，莢	
husky	a.聲音沙啞的	
hybrid	n.雜種；混血人	
hydrant	n.(消防)水龍頭；消防栓	
hydrate	n.水化物；v.水化	
hymn	n.讚美詩	
hyperactivity	n.活動過強，極度亢奮	
hyperbole	n.誇張法；a.誇張的	
hypertension	n.高血壓	
hyphen	n.連字型大小(即“-”)	
hypnotic	a.催眠的；n.催眠藥	
hypocrite	n.偽善者，偽君子	
hypocritical	a.虛偽的	
hypotenuse	n.(直角三角形的)斜邊	
hypothesis	n.假設，假說	
hypothetical	a.假設的	
hysteria	n.歇斯底里症	
icicle	n.冰柱，冰垂	
icon	n.聖像，偶像	
iconoclast	n.攻擊傳統觀念或風俗的人	
iconoclastic	a.對傳統觀念(或慣例)進行攻擊的	
ideology	n.思想體系，思想意識，意識形態	
idiom	n.習語，語言的習慣用法；特色	
idle	a.(指人)無所事事的；無效的；v.懶散，無所事事	
idolater	n.神像(偶像)崇拜者	
idyll	n.田園生活；田園詩	
igneous	a.火的，火絨的	
ignite	v.發光；點燃，燃燒	
ignoble	a.卑鄙的	
ignominious	a.可恥的；恥辱的	
ignominy	n.羞恥，屈辱	
ignorant	a.無知的，愚昧的	
illegal	a.違法的	
illegitimate	a.不合法的；私生的	
illicit	a.違法的	
illiterate	a.文盲的	
illuminate	v.闡明，解釋；照亮	
illuminati	n.先覺者，智者	
illusion	n.假像，錯覺	
illusive	a.迷惑人的，迷幻的	
illusory	a.虛幻的	
illustrate	v.為…作插圖或圖表；說明，闡明	
imbibe	v.飲；吸入	
imbroglio	n.糾紛，糾葛	
imbue	v.灌輸(某人)強烈的情感或意見	
imitation	n.贗品；效法，冒充	
imitative	a.模仿的	
immaculate	a.潔淨的，無瑕的	
immanent	a.內在的；普遍存在的	
immemorial	a.太古的，極古的	
immense	a.極大的；無限的	
immensity	n.巨大之物；無限	
immerse	v.浸入；沉浸於	
imminent	a.即將發生的，逼近的	
immolate	v.犧牲，焚祭	
immune	a.免疫的；免除的	
immunity	n.免疫；豁免	
immunize	v.使免疫	
immure	v.監禁	
imp	n.小鬼；頑童	
impact	n.衝擊，影響	
impair	v.損害，使弱	
impale	v.刺入，刺中	
impalpable	a.無法觸及的；不易理解的	
impart	v.傳授，告知	
impartial	a.公平的，無私的	
impasse	n.僵局；死路	
impassioned	a.慷慨激昂的	
impassive	a.無動於衷的，冷漠的	
impeach	v.指責；彈劾	
impeccable	a.無瑕疵的	
impecunious	a.不名一文的，貧困的	
impede	v.妨礙	
impediment	n.妨礙，阻礙物	
impel	v.推進；驅使	
impending	a.行將發生的，逼近的	
impenetrable	a.不能穿透的；不可理解的	
impenitent	a.不悔悟的	
imperative	a.急需的	
imperial	a.帝王的，至尊的	
imperious	a.傲慢的，專橫的	
impermanent	a.暫時的	
impermeability	n.不能滲透	
impermeable	a.不可滲透的，透不過的	
impersonate	v.模仿；扮演	
impertinence	n.無禮，粗魯	
imperturbable	a.冷靜的，沉著的	
impervious	a.不能滲透的；不為所動的	
impetuous	a.衝動的，魯莽的	
impetus	n.推動力；刺激	
impinge	v.侵犯；撞擊	
implant	v.注入；灌輸	
implausible	a.難以置信的	
implement	n.工具，器具；v.實現，實施	
implicate	v.牽連(於罪行中)	
implication	n.暗示	
implicit	a.含蓄的，不言而喻的	
implode	v.內爆；劇減	
implore	v.哀求，懇求	
impolitic	a.不智的，失策的	
imponderable	a.(重量等)無法衡量的	
import	n./v.進口，輸入；意義	
importune	v.強求，不斷請求	
impose	v.徵稅；強加	
imposing	a.壯麗的，雄偉的	
impostor	n.冒充者，騙子	
imposture	n.冒充	
impoverish	v.使成赤貧	
imprecise	a.不精確的，不嚴密的	
impregnable	a.攻不破的，征服不了的	
impresario	n.(劇院或樂團等)經理人，主辦者	
impressed	a.被打動的；被感動的	
impression	n.印象，感想；蓋印，壓痕	
impressionable	a.易受影響的	
imprint	v.蓋印，刻印	
impromptu	a.即席的，即興的	
improvident	a.無遠見的，不節儉的	
improvise	v.即席而作	
improvised	a.臨時準備的，即席而作的	
imprudent	a.輕率的；不智的	
impudent	a.魯莽的，無禮的	
impugn	v.指責，對…表示懷疑	
impuissance	n.無力，虛弱	
impulse	n.衝動；刺激	
impulsive	a.易衝動的	
impunity	n.免除懲罰	
inadvertence	n.漫不經心	
inadvertently	adv.不小心地，非故意地	
inalienable	a.不可剝奪的	
inane	a.無意義的；空洞的	
inanimate	a.無生命的	
inappreciable	a.微不足道的	
inaugural	a.就職的，開幕的	
inaugurate	v.舉行就職典禮；開創	
inborn	a.天生的，天賦的	
incandescence	n.白熾，熾熱發光	
incantation	n.咒語	
incarcerate	v.下獄，監禁	
incarnate	a.具有肉體的；化身的	
incendiary	a.放火的，縱火的	
incense	n.香，香味；v.激怒	
incentive	n.刺激，鼓勵；刺激因素	
inception	n.開端，開始；取得學位	
incessant	a.無間斷的，連續的	
inch	v.慢慢前進，慢慢移動	
inchoate	a.剛開始的；未發展的	
incidence	n.事情發生；發生率	
incinerate	v.焚化，毀棄	
incipient	a.初期的，剛出現的	
incise	v.切，切割	
incision	n.切口；切割	
incisive	a.一針見血的	
incite	v.激發，刺激	
inclement	a.(天氣)嚴酷的；嚴厲的	
inclusive	a.包含一切的，範圍廣的	
incogitant	a.無思想的，考慮不周的	
incommensurate	a.不成比例的，不相稱的	
incompatible	a.不能和諧共存的	
incompetent	a.無能力的，不能勝任的	
incongruity	n.不協調，不相稱	
inconsequential	a.不重要的，微不足道的	
inconstancy	n.(指人)反復無常	
incontrovertible	a.無可辯駁的	
incorporate	v.合併，併入	
incorrigibility	n.無可救藥	
incorrigible	a.積習難改的，不可救藥的	
incorruptible	a.(道德上)不受腐蝕的	
incredulity	n.懷疑，不相信	
increment	n.增值，增加	
incriminate	v.連累，牽連	
incubate	v.孵化	
incubation	n.孵卵期；潛伏期	
incubator	n.孵卵器；早產嬰兒保育箱	
incubus	n.惡夢；夢魘般的精神壓力，負擔	
inculcate	v.灌輸，諄諄教誨	
inculpate	v.連累；控告；歸咎於	
incumbent	n.在職者，現任者；a.義不容辭的	
incur	v.招惹	
indebted	a.感激的，感恩的	
indecipherable	a.無法破譯的	
indecisive	a.非決定性的，遲疑不決的	
indefatigable	a.不知疲倦的	
indelible	a.擦拭不掉的，不可磨滅的	
indemnify	v.賠償，償付	
indemnity	n.賠償；保證	
indent	v.切割成鋸齒狀	
indenture	n.契約，合同	
indeterminate	a.不確定的，不明確的	
indicate	v.顯示，指出；象徵	
indicative	a.暗示的	
indices	n.指數	
indict	v.控訴，起訴	
indifferent	a.不感興趣的，漠不關心的	
indigence	n.貧窮	
indigenous	a.土產的，本地的	
indigent	a.貧窮的，貧困的	
indignant	a.憤慨的，憤憤不平的	
indignation	n.憤慨	
indignity	n.侮辱，輕蔑；侮辱性的言行	
indispensability	n.不可缺少	
individual	a.單獨的，特有的；n.個人，個體	
indoctrinate	v.教導；灌輸思想	
indolent	a.懶惰的	
indubitable	a.不容置疑的	
induce	v.誘導；引起	
induct	v.使就職；使入伍	
induction	n.就職，入伍儀式；歸納	
indulge	v.放縱；滿足	
indurate	v.使堅硬；使習慣於	
industrious	a.勤勞的，勤勉的	
ineffable	a.妙不可言的	
ineffectual	a.無效的，徒勞無益的	
inelasticity	n.無彈性，無伸縮性	
ineluctable	a.不能逃避的	
inept	a.無能的；不適當的	
ineptitude	n.無能，不稱職	
inequity	n.不公正，不公平	
inert	a.惰性的；行動遲鈍的	
inertia	n.惰性；懶惰	
inexhaustible	a.用不完的，取之不竭的	
inexorable	a.不為所動的；堅決不變的	
inexplicable	a.無法解釋的	
infant	n.嬰兒	
infantile	a.幼稚的，孩子氣的	
infantry	n.步兵	
infatuation	n.迷戀	
infection	n.傳染，感染	
infelicitous	a.不幸的，不妥當的	
infelicity	n.不幸；不恰當	
infer	v.推斷，推定	
inferior	a.下級的，低等的，質次的，較差的	
inferno	n.火海，地獄般的場所	
infest	v.騷擾，擾亂	
infiltrate	v.滲透，滲入	
infinitesimal	a.極微小的；n.極小量	
infinity	n.無限的時間或空間	
infirm	a.虛弱的	
inflame	v.使燃燒；激怒(某人)	
inflamed	a.發炎的	
inflammation	n.激怒；熾熱；炎症	
inflate	v.使充氣，使膨脹	
inflict	v.遭受	
influx	n.注入，湧入	
informed	a.見多識廣的；消息靈通的	
infraction	n.違法	
infringe	v.違反，侵害	
infuriate	v.使(人)極為憤怒	
infuse	v.灌輸；鼓勵	
ingenious	a.聰明的，有發明天才的	
ing?nue	n.天真無邪的少女	
ingenuity	n.巧思，聰敏	
ingenuous	a.純樸的，單純的	
ingest	v.咽下，吞下	
ingestion	n.攝取，吸收；容納	
ingrained	a.根深蒂固的	
ingrate	n.忘恩負義的人	
ingratiate	v.逢迎，討好	
ingratiating	a.討好的，諂媚的	
ingredient	n.成分	
inhabit	v.棲居於，佔據	
inhabitant	n.居民；棲息的動物	
inhale	v.吸氣	
inherit	v.繼承	
inhibit	v.抑制	
inhibitor	n.抑制劑	
inhumane	a.不近人情的	
inimical	a.敵意的，不友善的	
inimitable	a.無法仿效的，不可比擬的	
iniquitous	a.邪惡的，不公正的	
iniquity	n.邪惡，不公正	
initial	a.開始的，最初的；n.(姓名的)首字母	
initiate	v.發起，創始；接納或介紹某人加入某團體等	
initiative	n.主動；首創精神	
injection	n.注射；注射劑	
injunction	n.命令，強制令	
injurious	a.有害的	
inkling	n.暗示，跡象；略知，模糊概念	
innate	a.生來的，天賦的	
innocence	n.無辜，清白	
innocuous	a.(行為，言論等)無害的	
innovation	n.創新，改革	
innovative	a.革新的	
innuendo	n.含沙射影，暗諷	
inoculate	v.預防注射	
inordinate	a.過度的，過分的	
inquiry	n.詢問	
inquisitive	a.過分好問的；好奇的	
inroad	n.突襲；消耗	
insatiable	a.不能滿足的，貪心的	
inscribe	v.在某物上寫，題	
inscrutable	a.高深莫測的，神秘的	
insecticide	n.殺蟲劑	
insensate	a.無感覺的；蠢笨的	
insentient	a.無知覺的，無生命的	
insert	v.插入	
insider	n.局內人，圈內人	
insidious	a.隱藏詭計的	
insignia	n.徽章，袖章	
insincerity	n.偽善	
insinuate	v.暗指，暗示	
insipid	a.乏味的，枯燥的	
insolence	n.傲慢，無禮	
insolent	a.粗野的，無禮的	
insoluble	a.不溶解的；不能解決的	
insolvency	n.無力償還；破產	
insomnia	n.失眠症	
insouciant	a.漫不經心的	
inspection	n.檢查，細看	
inspiration	n.啟示，靈感	
inspired	a.有創見的，有靈感的	
install	v.安裝，裝置；使就職	
instantaneous	a.立即的；瞬間發生的	
instate	v.任命，安置	
instigate	v.發起，煽動	
instill	v.滴注；逐漸灌輸	
instinctive	a.本能的	
institute	v.制定，創立(社團，規章)；n.學院，協會	
institution	n.公共機構，協會；制度	
institutionalized	a.制度化的，有組織的	
instructive	a.傳授知識的，啟蒙的	
instrumental	a.有幫助的，有作用的	
instrumentalist	n.樂器演奏者	
insubordinate	a.不服從的，反抗的	
insubstantial	a.非實體的；薄弱的	
insufficient	a.不足的	
insular	a.島嶼的；心胸狹窄的	
insularity	"n.島國狀態，島嶼生活狀況，與外界隔絕的生活狀況；(思想, 觀點等的)偏狹，性僵化"	
insulate	v.使絕緣；使隔離	
insulin	n.胰島素	
insurgent	a.叛亂的，起事的；n.叛亂分子	
insurrection	n.造反，叛亂	
intact	a.完整的，未動過的	
intangibility	n.無形，不可接觸	
intangible	a.不可觸摸的	
integral	a.構成整體所必需的；完整的	
integrate	v.使成整體	
integrity	n.正直，誠實；完整	
intellect	n.智力，思維能力	
intellectual	a.智力的，理智的；n.知識份子	
intelligible	a.可瞭解的，清晰的	
intensify	v.加劇	
intent	a.專心的，渴望的；n.目的，意向	
intentional	a.存心的，故意的	
inter	v.埋葬	
interaction	n.相互作用(影響)	
intercede	v.說好話，代為求情	
intercept	v.中途攔截，截取	
intercessor	n.仲裁者	
interchangeable	a.可互換的	
interdict	v.禁止；切斷(補給線)	
interference	n.干涉，妨礙	
interim	n.中間時期，過渡時期；a.暫時的	
interjection	n.插入語；感歎詞	
interlock	v.連鎖，連串	
interlocking	a.連鎖的	
interlude	n.(活動間的)暫時休息	
intermediary	n.仲裁者；中間物；a.中間的，媒介的	
interminable	a.無盡頭的	
intermingle	v.混合，摻雜	
intermission	n.暫停，間歇	
intermittent	a.斷斷續續的，間歇的	
intern	v.拘禁，軟禁；n.實習生	
internecine	a.內訌的，兩敗俱傷的	
interplay	v./n.相互影響	
interpolate	v.插入；篡改	
interpose	v.置於…之間；使介入	
interregnum	n.無王時期	
interrogate	v.審問，審訊	
interrogative	a.疑問的	
interrupt	v.暫時中止；打斷，打擾	
intersect	v.橫截，橫斷	
intersperse	v.散佈；點綴	
intertwine	v.糾纏，纏，繞	
intervene	v.干涉，介入	
intimate	a.親密的；n.密友；v.暗示	
intimidate	v.恐嚇；脅迫	
intoxicate	v.(使)沉醉，(使)欣喜若狂；(使)喝醉	
intractable	a.倔強的；難管的	
intransigent	a.不妥協的	
intrepid	a.無畏的，剛毅的	
intricacy	n.錯綜，複雜，紛亂	
intricate	a.複雜難懂的	
intrigue	v.密謀；引起…極大興趣	
introspective	a.自省的	
intrude	v.把(思想等)強加於，闖入	
intuition	n.直覺	
intuitive	a.直覺的	
inundate	v.淹沒；氾濫	
inured	a.習慣的	
invade	v.侵犯，侵入	
invective	n.猛烈抨擊，痛?	
inveigh	v.痛?，抨擊	
inveigle	v.誘騙，誘使	
inventory	n.詳細目錄；存貨清單	
inverse	a.相反的；倒轉的	
invert	v.上下倒置	
invertebrate	adj./n.無脊椎的(動物)	
investigate	v.調查	
inveterate	a.積習已深的	
invidious	a.惹人反感的，導致傷害和仇恨的，招人嫉妒的	
invigorate	v.鼓舞，激勵	
invigorating	a.使人有精神的，使人健壯的	
inviolable	a.不可侵犯的；不可褻瀆的	
invoke	v.祈求；懇求；(法律的)實施生效	
involuntary	a.無意的	
invulnerable	a.無法傷害的	
iodine	n.碘；碘酒	
iota	n.極小量，極少	
irascible	a.易發怒的	
irate	a.發怒的	
ire	n.憤怒；v.激怒	
iridescent	a.閃彩光的，現暈光的	
irk	v.使苦惱的，厭煩	
irksome	a.令人苦惱的，討厭的	
ironclad	a.裝鐵甲的；堅固的	
ironic	a.挖苦的；出乎意料的	
irony	n.反話	
irradicable	a.不能根除的	
irreconcilable	a.不能協調的，矛盾的	
irredeemable	a.無法挽回的	
irreducible	a.不能約的	
irremediable	a.無法治癒的，無法糾正的	
irrepressible	a.無法約束或阻止的	
irrevocable	a.無法取消的	
irrigate	v.灌溉	
irritable	a.易怒的；易受刺激的	
irritate	v.激怒；刺激	
irritation	n.憤怒，急躁，刺激	
isolate	v.孤立；將…從其種群中隔離	
isotope	n.同位素	
issue	v.出來，流出；發給，分發；n.(書刊的)期	
isthmus	n.地峽	
itinerant	a.巡迴的，流動的	
itinerary	n.行程表；旅行路線	
ivory	n.象牙，長牙	
jabber	v.快而不清楚地說	
jade	n.疲憊的老馬；玉，翡翠	
jaded	a.疲憊的；厭倦的；(膠捲)暴光過分的	
jagged	a.鋸齒狀的，不整齊的	
jamb	n.門窗的側柱	
jar	v.衝突，抵觸；震驚；發刺耳聲	
jargon	n.暗語；行話	
jarring	a.聲音刺耳的	
jaundice	n.偏見；黃疸	
jaundiced	a.有偏見的	
jaunt	n./v.短程旅遊	
jaunty	a.愉快的，滿足的	
jazz	n.爵士樂；喧鬧	
jealousy	n.猜忌，嫉妒	
jeer	v.嘲笑	
jejune	a.空洞的；不成熟的	
jerk	n./v.突然猛拉	
jeopardize	v.危及，危害	
jeopardy	n.危險	
jest	v./n.說笑，玩笑	
jettison	v.(船)向外拋棄東西；n.拋棄的貨物	
jibe	v.與…一致，符合	
jigsaw	n.拼圖遊戲	'p8zl]
jingoism	n.沙文主義；侵略主義	
jockey	n.騎師；v.用計謀獲取	
jocular	a.滑稽的，詼諧的；嬉戲的	
jocund	a.快樂的，高興的	
jog	v.慢而平靜地前進	
jolt	v.顛簸著移動；n.震動，搖晃	
jot	v.摘要記錄	
jovial	a.愉快的	
jubilation	n.歡快，歡慶	
judicial	a.法庭的，法官的	
judicious	a.有判斷力的；明智的	
judiciousness	n.明智	
juggernaut	n.摧毀一切的強大力量	
jumble	v.混雜，摻雜；n.混雜，摻雜	
junction	n.交叉路口；連接	
jurisdiction	n.司法權，審判權，裁判權	
justifiable	a.有理由的，無可非議的	
justification	n.正當理由，好的（正義的）原因；辨護	
justify	v.證明…是正當的	
juvenile	a.少年的，似少年的	
juxtapose	v.並排，並置	
kaleidoscope	n.萬花筒；產生有趣的對稱效果	
kangaroo	n.袋鼠	
ken	n.視野範圍；知識範圍	
kennel	n.狗舍，狗窩	
kernel	n.果仁；核心	
kidnap	v.誘拐，綁架，勒贖	
kidney	n.腎	
killjoy	n.令人掃興的人	
kin	n.親屬	
kindle	v.著火，點燃	
kindred	a.同類的，種族的	
kinetic	a.運動的	
knack	n.特殊能力；竅門	
knave	n.流氓，惡棍	
knead	v.揉制，捏制	
knit	v.編織	
knotty	a.有節疤的	
know-how	n.專業技能，知識	
kudos	n.榮譽	
labile	a.不穩定的	
labored	a.吃力的；(文體等)不自然的	
labyrinth	n.迷宮	
lace	n.鞋帶，系帶；網眼花邊，透孔織品	
lacerate	v.撕裂；深深傷害	
lachrymose	a.好流淚的；引人落淚的	
lackadaisical	a.無精打采的；無興趣的	
lackluster	a.無光澤的；呆滯的	
laconic	a.簡潔的	
lactic	a.乳汁的	
lag	v.落後，滯留	
lair	n.野獸的巢穴；躲藏處	
laity	n.俗信徒，俗人階級；外行	
lambaste	v.痛打；痛?	
lament	v./n.悲傷；哀悼	
lampoon	n.諷刺文章；v.諷刺	
lance	n.長矛；魚叉	
lancet	n.手術刀	
landfill	n.垃圾堆	
landlocked	a.被陸地包圍的	
landmark	n.陸標；里程碑	
landslide	n.山崩；壓倒性勝利	
languid	a.沒精打采的，倦怠的	
languish	v.變得消瘦；衰弱	
languor	n.身心疲憊	
lank	a.瘦削的；長而軟的	
lap	v.舔食；潑濺	
lapse	n.失誤；(時間等)流逝	
larder	n.食品室	
largess	n.贈送，賞賜；贈品；賀禮	
largesse	n.慷慨援助；施捨	
lark	n./v.玩樂，嬉耍	
larva	n.(昆蟲的)幼蟲	
lash	n.鞭子；v.鞭打；捆住	
lassitude	n.無力；沒精打采	
lasso	n.套索(捕捉牛、馬用)	
lasting	a.持久的，永久的	
latency	n.潛伏期	
latent	a.潛伏的	
lateral	a.側面的	
lathe	n.車床	
latitude	n.言行自由；緯度	
lattice	n.(做籬笆或爬藤架等的)格子架	
laud	v.稱讚	
lava	n.熔岩	
lave	v.洗浴；慢慢沖刷	
lavish	a.浪費的；豐富的	
laxative	a.(藥)通便的；放鬆的；n.輕瀉藥	
leak	v.洩漏；n.洩漏；漏出量，漏洞	
leakage	n.滲漏，漏出	
lease	n.租約；租期；v.出租	
leaven	n.發酵劑；影響力；v.發酵；影響	
lectern	n.教堂裡的讀經台	
ledger	n.帳簿	
leer	v.斜眼看，送秋波	
leery	a.機警的，懷疑的	
legacy	n.遺產；遺留之物	
legend	n.地圖裡的說明文字或圖例	
legerdemain	n.手法；戲法	
legion	n.兵團；一大群	
legislate	v.制定法律	
legislation	n.法律，法規，立法	
legislature	n.立法機關，立法團體	
legitimate	a.合法的；正當的	
leisureliness	n.悠然，從容	
leniency	n.溫和，寬容	
lenient	a.寬大的；仁慈的	
lethal	a.致命的	
lethargic	a.昏睡的	
lethargy	n.昏睡；倦怠；呆滯懶散	
levee	n.防洪堤；堤岸	
levelheaded	a.頭腦冷靜的，穩健的	
lever	n.杠杆；v.撬動	
levity	n.輕率；輕浮	
levy	v./n.徵稅；徵兵	
lexicographer	n.詞典編纂人	
liability	n.責任；債務	
liaison	n.聯繫；曖昧關係	
libel	v./n.(文字)誹謗，中傷	
liberality	n.慷慨；心胸開闊	
liberate	v.釋放，解放	
libertine	n.性行為放縱者，浪蕩的人	
liberty	n.隨意，冒失	
libretto	n.(歌劇等)歌詞；劇本	
license	n.放肆，自由；許可證，執照	
licentious	a.縱欲的；放肆的	
lien	n.扣押權；留置權	
ligneous	a.木質的，木頭的	
liken	v.把…比作…	
limb	n.肢(手或腳)，翼	
limber	a.易彎曲的；敏捷的	
limerick	n.五行打油詩	
limestone	n.石灰岩	
limited	a.有限的	
limn	v.描寫；畫	
limousine	n.大型轎車，大客車	
limp	v.跛行；a.軟弱的，鬆軟的	
limpid	a.清澈的；透明的	
lineage	n.宗系，血統	
linear	a.線的；成直線的	
linen	n.亞麻織品，亞麻布	
linger	v.逗留，留戀	
linguistic	a.語言的	
linguistics	n.語言學	
linoleum	n.油氈	
lint	n.繃帶用麻布，皮棉	
lionize	v.崇拜，看重	
liquefy	v.(使)液化，(使)溶解	
liquid	a.清澈的	
liquidate	v.清算；清償	
lissome	a.姿態優雅的，柔軟的	
list	v./n.傾斜	
listless	a.無精打采的	
literal	a.字面上的；忠實原義的；精確的	
literate	a.有讀寫能力的；有文化修養的	
literati	n.文人；學者(複數)	
lithe	a.柔軟的，易彎曲的；敏捷的，輕快的	
litigant	n.訴訟當事人	
litigation	n.訴訟	
litter	n.垃圾；一窩(動物)	
loaf	n.一條(麵包)；v.虛度光陰	
loath	a.不情願的，勉強的	
loathe	v.憎恨，厭惡	
lobby	n.大廳，休息廳	
lobe	n.耳垂；(肺、肝等的)葉	
locale	n.事件發生的現場、地點	
locomotion	n.運動，移動	
locomotive	a.移動的；n.機車，火車頭	
locus	n.地點，所在地	
lode	n.礦脈	
lofty	a.崇高的，高尚的	
log	n./v.日誌，記錄；n.一段大木頭；圓木	
logistics	n.後勤學；後勤	
loll	v.懶洋洋地坐或臥	
longevity	n.長壽	
longing	n.渴望	
long-winded	a.冗長的	
loom	n.織布機；v.(威脅性)隱約出現	
loon	n.愚人；瘋子	
loop	n.圈，金屬線圈	
loophole	n.槍眼，小窗，換氣孔	
loosen	v.變松，鬆開	
lope	n.輕快的步伐；v.使大步慢跑；跳躍	
lopsided	a.傾向一方的，不平衡的	
loquacious	a.多嘴的，饒舌的	
lot	n.簽；命運；v.抽籤，劃分	
lottery	n.彩票，抽彩給獎法	
lounge	v.懶散地斜靠；n.休息室	
loutish	a.粗魯的	
low	v.牛叫	
loyal	a.忠誠的，忠貞的，忠心的	
lubricant	n.潤滑劑	
lubricate	v.潤滑	
lucid	a.表達清楚的，明白易懂的	
lucrative	a.賺錢的，有利可圖的	
ludicrous	a.荒唐可笑的	
lug	v./n.拖，拉	
lukewarm	a.微溫的，不熱心的	
lull	n.活動的暫停；v.使平靜	
lullaby	n.搖籃曲	
lumber	v.蹣跚而行，笨拙地走；n.雜物；木材	
lumberjack	n.伐木工	
lumen	n.流明(光通量單位)	
luminary	n.傑出人物，名人	
lump	n.一塊，腫塊；v.形成塊狀	
lunar	a.月亮的	
lunatic	n.瘋子；a.極蠢的	
lurch	n.突然向前或旁邊倒；v.蹣跚而行	
lurid	a.耀眼的；駭人聽聞的	
lurk	v.潛伏，埋伏	
lush	a.繁茂的，茂盛的	
lust	n.強烈的欲望	
lustrous	a.有光澤的	
luxuriant	a.繁茂的；肥沃的	
luxurious	a.奢侈的，豪華的	
luxury	n.奢侈(品)	
lyric	a.抒情的；n.抒情詩；歌詞	
macabre	a.駭人的，可怖的	
macerate	v.浸軟；消瘦	
machination	n.陰謀	
maculated	a.有斑點的	
madrigal	n.抒情短詩，情歌，合唱曲	
maelstrom	n.大漩渦；大混亂	
magenta	n./a.紫紅色(的)；n.紫紅色的染料	
magisterial	a.有權威的；威風的	
magnanimity	n.慷慨	
magnanimous	a.寬宏大量的，慷慨的	
magnate	n.財主，巨頭	
magnificent	a.壯麗的，宏偉的；高尚的	
magnify	v.放大；讚美	
magnitude	n.重要；星球的光亮度	
magpie	n.鵲；饒舌的人	
maintenance	n.維持，維護	
maize	n.玉米	
majestic	a.雄偉的，莊嚴的	
maladroit	a.笨拙的	
malaise	n.不適，不舒服	
malapropism	n.字的誤用	
malcontent	a.不滿的；n.不滿分子，反抗者	
malevolent	a.有惡意的，惡毒的	
malfeasance	n.不法行為，瀆職	
malfunction	v.發生故障；n.故障，障礙	
malicious	a.惡意的，怨毒的	
malign	v.誹謗，中傷；a.邪惡的	
malinger	v.裝病以逃避工作	
malleable	a.可塑的，易改變的	
malpractice	n.怠忽職守，瀆職	
mammal	n.哺乳動物	
mammoth	a.巨大的	
mandate	n.命令，指令	
mandatory	a.命令的，強迫的	
mangle	v.毀損；撕成碎片，壓碎	
mania	n.癲狂；狂熱	
manifest	a.顯然的	
manifestation	n.表明，顯示	
manifesto	n.宣言，聲明	
manifold	a.繁多的；多種的	
manipulate	v.操縱	
manipulative	a.操縱別人的，老於世故的	
mannered	a.做作的	
mansion	n.公館；大廈	
mantle	n.披風，斗篷；v.覆蓋	
manumit	v.解放(奴隸)	
manure	n.糞肥；v.給…施肥	
manuscript	n.手稿；手抄本	
maple	n.楓樹(楓樹是加拿大的國樹)	
mar	v.破壞，損傷	
marble	n.大理石	
mare	n.母馬，母驢	
margarine	n.人造黃油	
margin	n.頁邊空白，邊緣；差額；餘地；利潤	
marginal	a.書頁空白處的；不重要的	
marine	a.海的；海中的	
marionette	n.木偶	
marital	a.婚姻的	
maritime	a.沿海的；海上的	
marked	a.明顯的；被監視的	
maroon	n./a.栗色(的)	
marred	a.受傷的；毀壞變形的	
marsh	n.沼澤地，濕地	
marshal	v.整理，安排，設置	
marsupial	n./a.有袋動物(的)	
martial	a.戰爭的，軍事的	
martyr	n.烈士，殉道者	
marvel	v.對…感到驚異；n.奇跡	
mash	v.搗成糊狀	
mask	n.假面具；v.隱藏(感情)	
mason	n.泥瓦匠，石匠	
masquerade	n.化裝舞會；v.偽裝	
massacre	n.大屠殺	
massive	a.巨大的，厚重的	
mast	n.船桅，旗杆	
masticate	v.咀嚼；把…磨成漿	
mate	n.夥伴；配偶；v.交配	
materialize	v.賦予形體，使具體化；實現	
maternal	a.母性的	
matrix	n.模子；矩陣	
mattress	n.床墊	
mature	a.成熟的；深思熟慮的	
maturity	n.成熟，完備	
maudlin	a.感情脆弱的，愛哭的	
maul	v.撕裂皮肉，傷害	
mauve	a.淡紫色的	
maven	n.專家，內行	
maverick	n.想法與眾不同的人	
mawkish	a.自作多情的；淡而無味的，令人作嘔的	
maximize	v.使增至最大限度	
maze	n.迷宮	
meager	a.貧乏的；削瘦的	
mean	a.卑賤的，吝嗇的	
meander	v.蜿蜒而流；漫步	
measly	a.患麻疹的；小得可憐的	
measured	a.精確的；慎重的	
mechanical	a.機械的，機械製造的；機械似的，呆板的，體力的	
mechanics	n.力學	
mechanism	n.結構，機制	
medal	n.獎牌，勳章	
meddle	v.干涉，干預	
meddlesome	a.愛管閒事的	
mediate	v.調停	
medieval	a.中世紀的，中古的	
mediocre	a.平庸的，平凡的	
mediocrity	n.平庸，碌碌無為	
meditate	v.沉思，反省	
meditation	n.沉思，冥想	
meditative	a.沉思的，善於思考的	
medium	n.媒介；(細菌等的)生存環境	
medley	n.混合歌曲；混雜；各種各樣的集團	
meek	a.溫順的，順服的	
meet	a.合適的	
melancholy	a.憂鬱的；令人悲傷的	
meld	v.(使)混合，(使)合併	
mellifluous	a.(音樂等)柔美流暢的	
melodrama	n.情節劇；音樂戲劇	
melody	n.旋律；歌曲	
melon	n.甜瓜	
membrane	n.薄膜；細胞膜	
memoir	n.回憶錄，自傳；記事錄	
memorial	n.紀念碑，紀念物；a.紀念的，悼念的	
menace	v./n.威脅，危險	
mend	v.修改，改進	
mendacious	a.不真的；撒謊的	
mendacity	n.虛假	
mendicant	a.行乞的；n.乞丐	
menthol	n.薄荷醇	
mentor	n.導師	
mercantile	a.貿易的，商業的	
mercenary	a.惟利是圖的；n.雇傭兵	
mercurial	a.善變的；活潑的	
meretricious	a.華而不實的，俗豔的	
merit	v.值得	
merited	a.該得的，理所當然的	
meritorious	a.值得讚賞的	
mesa	n.高臺地，平頂山	
mesh	v.用網捕捉；齒合	
metabolism	n.新陳代謝	
metamorphose	v.變形	
metaphor	n.隱喻，暗喻	
metaphysical	a.形而上學的，玄學的	
metaphysics	n.形而上學，玄學	
mete	v.給予，分配；測量；n.邊界	
meteoric	a.流星的；曇花一現的	
meteorology	n.氣象學	
methodical	a.細心的，有條不紊的	
meticulous	a.細心的，一絲不苟的	
metrical	a.測量的；韻律的	
metropolis	n.大城市	
metropolitan	a.大都市的，首都的	
mettle	n.勇氣，鬥志	
mettlesome	a.精神抖擻的	
microbe	n.微生物	
microorganism	n.微生物，細菌	
microscope	n.顯微鏡	
microscopic	a.極小的；顯微鏡的	
miff	n.小爭吵	
mighty	a.強有力的，強大的	
migratory	a.遷移的，流浪的	
milestone	n.里程碑；轉捩點	
militia	n.民兵	
milk	v.榨取	
mill	n.磨坊；壓榨機；製造廠	
mime	n.默劇表演；默劇(演員)	
mimic	v.模仿，戲弄；n.模仿他人言行的人	
minaret	n.清真寺的尖塔	
minatory	a.威脅的，恫嚇的	
mince	v.切碎；小步走路	
mingle	v.混合	
miniature	n.小畫像；縮影	
minimize	v.把…減至最低數量或程度	
minion	n.奴才，低下之人	
minnow	n.鰷魚，小淡水魚	
mint	n.大量；巨額	
minuet	n.小步舞	
minuscule	a.極小的	
minutes	n.會議記錄	
minutia	n.細枝末節，細節	
miracle	n.奇事，奇跡	
mirage	n.幻影，海市蜃樓	
mire	n.泥沼；困境；v.使…陷入困境	
mirth	n.歡樂，歡笑	
misanthrope	n.憤世嫉俗者	
mischievous	a.淘氣的；有害處的	
miscreant	n.惡棍，歹徒	
miser	n.守財奴，吝嗇鬼	
miserly	a.吝嗇的，貪婪的	
misgiving	n.擔心，疑慮	
misinform	v.向…提供錯誤資訊	
misnomer	n.名字的誤用	
misperceive	v.誤解	
misrepresent	v.誤傳，歪曲	
misrepresentation	n.歪曲	
misshapen	a.畸形的，奇形怪狀的	
missile	n.發射物；導彈	
mite	n.極小量；小蟲	
mitigate	v.減輕，緩和	
mitten	n.(四指套在一起拇指分開的)連指手套	
mnemonics	n.記憶法，記憶規則	
moan	v./n.(痛苦地/的)呻吟；(不滿地/的)抱怨	
moat	n.壕溝；護城河	
mobile	a.易於移動的	
mobility	n.可動性，流動性	
mock	v.嘲笑；模仿地嘲弄	
mode	n.樣式，時尚；模式	
modest	a.謙虛的，謹慎的；適度的	
modicum	n.少量	
modify	v.修改，變更	
modish	a.時髦的	
modulate	v.調整(音的強弱)	
mogul	n.顯要人物，權勢之人	
molar	n.臼齒	
mold	n.模子；(美)黴；v.塑造	
molding	n.裝飾線條；鑄造物	
moldy	a.發黴的	
molecule	n.分子	
mollify	v.安慰，安撫	
mollycoddle	v.過分愛惜，嬌慣；n.嬌生慣養的人	
molt	v.換羽，脫毛；n.換羽(期)，脫毛(期)	
molten	v.熔化；a.熔化的	
moment	n.瞬間；重要	
momentous	a.極重要的，嚴重的	
momentum	n.推進力，勢頭	
monarch	n.君主，帝王	
monarchy	n.君主制	
monetary	a.貨幣的	
mongrel	n.雜種動物；混血兒	
monochromatic	a.單色的	
monochrome	a.單色的，單色畫的	
monocle	n.單片眼鏡	
monogamy	n.一夫一妻制	
monolithic	a.巨石的，巨大的	
monologue	n.獨白；個人長篇演說	
monomania	n.偏狂症，狂熱病	
monopoly	n.專利權，壟斷	
monotonous	a.單調的，無聊的	
monotony	n.單調，千篇一律	
monsoon	n.季雨，季風	
montage	n.蒙太奇；拼集畫	
monumental	a.極大的；紀念碑的	
morale	n.士氣，精神力量	
moralistic	a.道學氣的	
moratorium	n.停止償付；禁止活動	
morbid	a.病態的，不正常的	
mordant	a.譏諷的，尖酸的	
mores	n.風俗習慣，道德觀念	
moribund	a.即將結束的；垂死的	
morose	a.陰鬱的	
morsel	n.一小塊(食物)；小量	
mortality	n.死亡率	
mortar	n.小臼，乳缽；迫擊炮	
mortgage	n.抵押貸款；抵押證書；v.用…作抵押	
mortification	n.恥辱，屈辱	
mortify	v.使屈辱，使痛心	
mortuary	n.停屍間，太平間	
mosaic	n.馬賽克；鑲嵌細工(把小塊玻璃石頭等鑲嵌成圖畫)	
mosque	n.清真寺(伊斯蘭教的寺廟)	
mosquito	n.蚊子	
mote	n.微粒，微塵	
motif	n.(作品)主題，主旨	
motility	n.運動性	
motley	a.混雜的；雜色的	
mottled	a.有雜色的，斑駁的	
motto	n.座右銘；箴言	
mountainous	a.多山的；巨大的	
mourn	v.哀悼，哀傷	
mournful	a.悲傷的	
movement	n.(交響樂)樂章	
muffle	v.使聲音降低；裹住	
muffled	a.(聲音)壓低的	
muffler	n.消音器；圍巾	
mulish	a.騾一樣的，執拗的	
multiple	a.多樣的，多重的	
multiplicity	n.多樣性	
multiply	v.乘；增加；繁殖	
mumble	v.咕噥，含糊不清地說	
mundane	a.現世的，世俗的	
municipality	n.市；市政當局(指城市行政區及管理者)	
munificence	n.慷慨，寬宏大量	
munition	n.軍火，彈藥	
mural	a.牆壁的；n.壁畫	
murky	a.黑暗的；朦朧的	
murmur	v.柔聲地說，喃喃而言	
muscle	n.肌肉；肌肉的力量	
muscular	a.肌肉的；強健的	
muse	v.沉思，冥想	
mushroom	n.蘑菇；v.雨後春筍般迅速發展	
musicologist	n.音樂學者	
musket	n.舊式步槍	
muster	v.召集，聚集	
mutate	v.變異	
mute	a.沉默的；v.減弱聲音；n.弱音器	
muted	a.(聲音)減弱的，變得輕柔的	
mutineer	n.反叛者，背叛者	
mutter	v.咕噥，嘀咕	
myopia	n.近視；缺乏遠見	
myopic	a.近視眼的；缺乏辨別力的	
myriad	a.許多的，無數的	
mystic	a.神秘的，不可思議的；n.神秘主義者	
nadir	n.最低點	
nag	v.嘮叨，煩擾	
naive	a.天真的，純樸的	
narcissism	n.自戀，自愛	
narcissist	n.自負的人，自戀者	
narcotic	n.催眠藥；a.催眠的	
narrative	a.敘述的，講故事的	
nascent	a.初生的，萌芽的	
natal	a.出生的，誕生時的	
natty	a.整潔的；瀟灑的	
nausea	n.作嘔，噁心	
nauseate	v.使作嘔，使厭惡	
nautical	a.船員的，航海的	
navigate	v.航海，導航	
naysay	v.拒絕，說不	
nebulous	a.模糊不清的；雲狀的	
needle	n.針；針葉	
needlework	n.縫紉，刺繡	
needy	a.貧窮的	
nefarious	a.違法的，邪惡的	
negate	v.取消；否認	
negation	n.否定，拒絕	
negligence	n.粗心，疏忽	
negotiable	a.可商量的	
negotiate	v.商議，談判，交涉	
neolithic	a.新石器時代的	
neologism	n.新字，新義	
neophyte	n.初學者，新手	
nepotism	n.裙帶關係	
nerve	n.勇氣；v.給予力量或勇氣	
nettle	n.蕁麻；v.煩憂，激惱	
neurology	n.神經學	
neutralize	v.使無效；中和	
neutron	n.中子	
nexus	n.(看法等的)聯繫，連結	
nib	n.鋼筆尖	
nibble	v.一點點地咬，慢慢啃	
nice	a.精密的	
nicety	n.準確，精確	
nick	n.小傷口，刻痕	
nicotine	n.尼古丁	
nightmare	n.惡夢；可怕的事	
nil	n.無，零	
nip	v.小口啜飲	
nitpick	v.挑剔，吹毛求疵	
nocturnal	a.夜晚的，夜間發生的	
noisome	a.惡臭的；令人不快的	
nomad	n.流浪者；遊牧部落的人	
nomadic	a.遊牧的	
nominal	a.名義上的，有名無實的	
nominate	v.提名；任命，指定	
nonchalance	n.冷漠，缺少關懷；沉著	
nonchalant	a.冷漠的	
noncommittal	a.態度暖味的；不承擔義務的	
nonconformist	adj./n.不遵照傳統生活的(人)	
nonentity	n.不重要之人或事	
nonflammable	a.不易燃的	
nonplus	v.使窘困迷惑；n.迷惑，窘境	
nonporous	a.無孔的，不滲透的	
nonradioactive	a.非放射性的	
nonsensical	a.荒唐的，無意義的	
nonthreatening	a.不威脅的	
nonviable	a.無法生存的	
norm	n.規範，準則	
nostalgia	n.懷舊之情	
nostrum	n.家傳秘方；萬靈丹	
notable	a.明顯的，出眾的，重要的	
notch	n.V字形刻痕	
notorious	a.臭名昭著的	
nourish	v.滋養，懷有(希望等)	
nova	n.新星	
novelty	n.新奇(的事物)	
novice	n.生手，新手	
noxious	a.有害的，有毒的	
nuance	n.細微的差異	
nubile	a.(女孩)到婚嫁年齡的；吸引人的	
nucleate	v.使成核	
nucleus	n.(原子)核	
nudge	v.(用肘)輕觸，輕推	
nugatory	a.無價值的，瑣碎的	
nullify	v.使無效，取消	
numb	a.麻木的	
numerous	a.許多的，很多的	
numismatist	n.錢幣學家，錢幣收藏家	
nurture	v.撫育，給…營養物，教養；n.養育，營養物；(總稱)環境因素	
nutrient	n.滋養物質	
nutrition	n.營養	
oafishness	n.癡呆	
oak	n.橡樹	
oasis	n.綠洲	
oath	n.誓言；咒?	
obdurate	a.固執的，頑固的	
obedient	a.服從的，順從的	
obeisance	n.鞠躬，敬禮	
obese	a.極肥胖的	
obfuscate	v.使困惑，使迷惑	
obituary	n.訃聞，訃告	
objection	n.厭惡，反對	
objective	a.客觀的；n.目標	
obligation	n.責任；債務，欠的人情	
obligatory	a.強制性的，義務的	
oblige	v.束縛；恩惠於…	
obliging	a.懇切的，熱心助人的	
oblique	a.間接的；斜的	
obliterate	v.塗掉，擦掉	
oblivious	a.遺忘的，疏忽的	
obloquy	n.大罵，斥責	
obnoxious	a.令人不愉快的；可憎的	
obscure	a.難理解的；不清楚的；v.隱藏；使…模糊	
obscurity	n.費解，不出名	
obsequious	a.逢迎的，諂媚的	
observatory	n.天文臺	
obsess	v.迷住；使…困窘，使…煩擾	
obsessed	a.心神不寧的	
obsession	n.入迷；固執的念頭	
obsolescent	a.即將過時的	
obsolete	a.廢棄的；過時的	
obstacle	n.障礙，干擾	
obstinacy	n.固執，倔強，頑固	
obstinate	a.固執的，倔強的	
obstreperous	a.吵鬧的，難管束的	
obstruct	v.阻塞，截斷	
obstruction	n.阻礙(物)，妨礙	
obtainable	a.能得到的	
obtuse	a.愚笨的；不銳利的	
obverse	n./a.正面(的)	
obviate	v.排除(困難)	
obvious	a.明顯的，顯而易見的	
occlude	v.使閉塞	
occult	a.秘密的，不公開的	
occupation	n.工作，職業；佔領	
occurrence	n.事件；發生	
octogenarian	n.80～89歲的老人	
odds	n.機會，可能性	
ode	n.長詩，頌歌	
odious	a.可憎的，討厭的	
odium	n.憎惡，反感	
odometer	n.(汽車)里程表	
odyssey	n.長途的冒險旅行	
offbeat	a.不規則的，不平常的	
offence(offense)	n.得罪；錯事	
offend	v.得罪，冒犯	
offensive	a.令人不快的，得罪人的	
offhand	adv./a.事先無準備地(的)；隨便地(的)	
officious	a.愛發命令的，好忠告的；過度殷勤的	
offish	a.冷淡的	
off-key	a.走調的，不和諧的	
offset	v.補償，抵消	
offspring	n.兒女，後代	
offstage	adv./a.台後(的)，幕後(的)	
ogle	v.送秋波；n.媚眼	
ointment	n.油膏，軟膏	
olfaction	n.嗅覺	
oligarchy	n.寡頭政治	
omelet	n.煎蛋捲	
ominous	a.預兆的，不祥的	
omit	v.省略，遺漏；疏忽	
omnipotent	a.全能的，萬能的	
omnipresent	a.無處不在的	
omniscient	a.無所不知的，博識的	
onerous	a.繁重的，麻煩的	
onset	n.(壞情況)開始發作	
opacity	n.不透明性，晦澀	
opalescence	n.(不透明的)乳白光	
opaque	a.不透明的；難懂的	
operative	a.(計畫等)實施中的；生效的	
operetta	n.小歌劇	
opine	v.想，以為	
opinionated	a.固執己見的	
opponent	n.對手，敵手	
opportune	a.合適的，適當的	
oppose	v.反對	
oppress	v.壓迫，壓制	
opprobrious	a.辱?的，惡名聲的	
optimism	n.樂觀主義	
optimist	n.樂觀主義者	
optimum	a.最好的，最有利的	
optional	a.可自由選擇的	
opulent	a.富裕的；充足的	
oracle	n.代神發佈神諭的人	
oration	n.正式演說，演講	
oratorio	n.清唱劇(沒有舞臺行動、道具的戲劇)	
oratory	n.演講術	
orchard	n.果園	
orchestra	n.管弦樂隊	
ordain	v.任命(神職)；頒發命令	
ordeal	n.嚴峻考驗，痛苦經驗	
ordinance	n.法令，條例	
ordnance	n.大炮；軍械	
ore	n.礦，礦石	
organism	n.生物；有機體	
orient	a.上升的；v.確定方向；使熟悉情況	
original	a.最初的，原始的；有創意的	
originality	n.創造性，獨特性	
ornate	a.華美的；充滿裝飾的	
ornithologist	n.鳥類學家，鳥類學者	
ornithology	n.鳥類學	
orthodontics	n.畸齒矯正學	
orthodox	a.正統的	
oscillate	v.擺動；猶豫	
osmosis	n.滲透；潛移默化	
osseous	a.骨的，多骨的	
ossify	v.硬化，骨化；使(傳統)僵化	
ostensible	a.表面上的	
ostentation	n.誇示，炫耀	
ostracism	n.放逐，排斥	
ostracize	v.放逐，排斥	
ostrich	n.鴕鳥；不接受現實的人	
other-directed	a.受人支配的	
otter	n.水獺	
oust	v.驅逐；把…趕走	
outgoing	a.友善的；即將離去的	
outgrowth	n.自然結果；生長物	
outlandish	a.古怪的	
outlet	n.出口	
outline	n.輪廓；梗概	
outmaneuver	v.以策略制勝	
outmoded	a.不再流行的	
outrage	n.暴行	
outset	n.開始，開頭	
outshine	v.要求比…更好	
outskirts	n.郊區，郊外	
outspoken	a.直言不諱的	
outstrip	v.超過；跑過	
outwit	v.以機智勝過	
ovation	n.熱烈的歡迎、鼓掌	
overbearing	a.專橫的，獨斷的	
overdose	n.(藥物)過大的劑量	
overdue	a.過期未付的；逾期的	
overexposure	n.過分暴露，(照相)暴光過度	
overflow	v.溢出；洋溢	
overhaul	v.徹底檢查；大修	
overlap	v.(部分地)重疊	
overlook	v.忽視；俯視	
overpowering	a.壓倒性的，不可抗拒的	
overreach	v.做事過頭	
override	v.不理會；蹂躪，踐踏	
overriding	a.最主要的，優先的	
overrule	v.(高位的人)否決(低位的人或事)	
oversee	v.監督	
overshadow	v.遮蔽，使失色	
overstate	v.誇張，對…言過其實	
overt	a.公開的，非秘密的	
overthrow	v./n.推翻；終止	
overture	n.前奏曲，序曲	
overturn	v.翻倒；推翻	
overwhelm	v.氾濫；壓倒	
overwrought	a.緊張過度的	
owl	n.貓頭鷹	
oxidize	v.氧化，生銹	
pacifist	n.和平主義者，反戰主義者	
pacify	v.使安靜，撫慰	
pack	n.狼群；一群動物	
packed	a.充滿人的，擁擠的	
pact	n.協定，條約	
padding	n.襯墊，填料	
paean	n.讚美歌，頌歌	
pagan	n.沒有宗教信仰的人；異教徒	
pageant	n.壯觀的遊行；露天歷史劇	
painkiller	n.止痛藥	
painstaking	a.煞費苦心的	
palate	n.上齶；口味；愛好	
palatial	a.宮殿般的；宏偉的	
paleolithic	a.舊石器時代的	
paleontology	n.古生物學	
palette	n.調色板，顏料配置	
pall	v.令人發膩，失去吸引力	
palliate	v.減輕(痛苦)；掩飾(罪行)	
palliative	n.緩釋劑；a.減輕的，緩和的	
pallid	a.蒼白的，沒血色的	
palmy	a.繁榮的；棕櫚的	
palpable	a.可觸知的，明顯的	
palpitate	v.(心臟)急速而不規則地跳動	
palter	v.含糊其詞	
paltry	a.無價值的，微不足道的	
pamphlet	n.小冊子	
pan	v.嚴厲批評	
panacea	n.萬靈藥	
panache	n.羽飾；炫耀	
pancreas	n.胰腺	
pandemic	a.(病)大範圍流行的	
pandemonium	n.喧囂，大混亂	
pander	v.慫恿，迎合(不良欲望)	
panegyric	n.頌詞，頌揚	
panel	n.專門小組；儀錶板	
pang	n.一陣劇痛	
panic	a.恐慌的；n.恐慌，驚惶	
panorama	n.概觀，全景	
panther	n.黑豹	
pantomime	n.默劇	
pantry	n.食品室	
papyrus	n.莎草；莎草紙	
parable	n.寓言，比喻	
parabola	n.?物線	
paradigm	n.範例，示範	
paradox	n.矛盾；似矛盾而正確的說法	
paragon	n.模範，典型	
parallel	a.平行的；類似的；n.平行線；v.與…相似	
parallelism	n.平行，類似	
parameter	n.參量，變數	
paramount	a.最重要的，最高權力的	
paranoia	n.偏執狂	
paranoid	a.偏執狂的，過分懷疑的	
paraphrase	v.傳譯，釋義	
parasite	n.食客；寄生物	
parch	v.烘烤；烤焦	
pare	v.削；修剪；削減，縮減	
pariah	n.賤民，被社會遺棄者	
parity	n.(水準，地位，數量等的)同等，相等	
parka	n.派克大衣(毛皮風雪大衣)	
parlance	n.說法，用語，詞彙	
parody	n.模仿性嘲弄文章或表演；拙劣的模仿	
paroxysm	n.(感情等)突發	
parquet	n.鑲木地板	
parry	v.擋開，避開(武器，問題等)	
parse	v.對…作語法分析	
parsimony	n.過分節儉，吝嗇	
partial	a.局部的；偏袒的	
partiality	n.偏袒，偏心	
particular	n.事實，細節	
particularize	v.詳述，列舉	
partisan	n.黨派支持者；黨徒	
partition	n.隔開；隔牆	
passionate	a.充滿激情的	
passive	a.被動的，缺乏活力的	
pastel	n.彩色粉筆或蠟筆畫；柔和的色彩	
pasteurize	v.加熱殺菌，消毒	
pastiche	n.混合拼湊的作品	
pastoral	a.田園生活的；寧靜的	
pastry	n.糕點，點心	
patch	n.補丁；一小片(土地)	
patent	a.顯而易見的；n.專利權(證書)	
pathogen	n.病原體	
pathological	a.病態的；病理的	
pathology	n.病理學	
patina	n.綠鏽；光亮的外表	
patrician	n.貴族	
patrimony	n.祖傳的財產	
patriot	n.愛國者，愛國主義者	
patriotism	n.愛國主義，愛國心	
patronage	n.贊助，惠顧	
patronize	v.以高人一等的態度對待；光顧，惠顧	
paucity	n.小量，缺乏	
paunchy	a.大肚子的	
pauper	n.貧民，乞丐	
peak	v.憔悴，消瘦	
pecan	n.山核桃	
peccadillo	n.小過失	
peck	v.啄食；輕啄	
pedagogue	n.教師，教育者	
pedagogy	n.教育學，教學法	
pedal	n.踏板，腳蹬；v.騎腳踏車	
pedant	n.迂腐之人，書呆子	
pedestal	n.(柱石或雕像的)基座	
pedestrian	a.徒步的；缺乏想像的；n.行人	
pediatrics	n.小兒科	
peel	v.削去…的皮；剝落；n.外皮	
peer	n.同等之人，同輩	
peerless	a.無可匹敵的	
peeve	v.使氣惱，怨恨	
peevish	a.壞脾氣的，易怒的	
pejorative	a.帶有輕蔑意義的，貶低的	
pelf	n.錢財；不義之財	
pell-mell	adv.混亂地	
pellucid	a.清晰的，清澈的	
pen	n.圍欄；監禁；母天鵝	
penalize	v.置(某人)於不利地位；處罰	
penalty	n.刑罰，處罰	
penance	n.自我懲罰	
penchant	n.愛好，嗜好	
pending	a.即將發生的；未決的	
pendulum	n.擺，鐘擺	
penetrate	v.刺穿；滲入；瞭解	
penicillin	n.盤尼西林，青黴素	
peninsula	n.半島	
penitent	a.後悔的，懺悔的	
pennant	n.(船上用的)信號旗	
penultimate	a.倒數第二的	
penury	n.貧窮；吝嗇	
perambulate	v.巡視；漫步	
perception	n.感覺；洞察力	
perch	v.(鳥)棲息	
percussionist	n.敲擊樂器的樂師	
peregrination	n.遊歷(尤指在國外)	
peremptory	a.不容反抗的；專橫的	
perennial	a.終年的；永久的	
perfervid	a.非常熱心的	
perfidious	a.不忠的，背信棄義的	
perfidy	n.不忠，背叛	
perforate	v.打洞	
perfunctorily	adv.敷衍地，潦草地，表面地	
perfunctory	a.草率的，敷衍的	
peril	n.危險	
perilous	a.危險的，冒險的	
perimeter	n.周長	
periodical	n.期刊	
peripatetic	a.巡遊的	
peripheral	a.不重要的，週邊的	
periphery	n.不重要的部分；週邊	
periscope	n.潛望鏡	
perish	v.死，暴卒	
perishing	a.嚴寒的	
perjure	v.作偽證，發假誓	
perjury	n.作偽證，發假誓	
perky	a.神氣的；活潑的	
permanence	n.永久，持久	
permanent	a.長久的，永久的	
permeable	a.可滲透的(penetrable)	
permeate	v.擴散；滲透	
permissive	a.過分縱容的	
pernicious	a.有害的，致命的	
perpendicular	a.垂直的	
perpetual	a.連續不斷的；永久的	
perpetuate	v.使永存，使永記不忘	
perquisite	n.固定津貼，利益	
persecute	v.迫害	
persiflage	n.挖苦，嘲弄	
persistence	n.堅持不懈，持續	
personable	a.英俊的，風度好的	
personification	n.典型，化身，完美榜樣	
personnel	n.全體人員，員工	
perspective	n.(判斷事物的)角度，方法；透視法	
perspicacious	a.獨具慧眼的	
perspicuity	n.明晰；聰明睿智	
perspicuous	a.明晰的；明瞭的	
perspire	v.流汗	
pertain	v.屬於；關於	
pertinacious	a.固執的；無法駕禦的；不妥協的	
pertinent	a.有關的，相關的	
peruse	v.細讀，精讀	
pervade	v.彌漫，普及	
pervious	a.可滲透的	
pessimism	n.悲觀；悲觀主義	
pest	n.害蟲；討厭的人或物	
pester	v.糾纏，強求	
pesticide	n.殺蟲劑	
pestilent	a.致死的；有害的	
pestle	n.杵，乳缽槌	
petal	n.花瓣	
petition	n.請願；請願書	
petitioner	n.請願人	
petrify	v.石化；嚇呆	
petroglyph	n.岩石雕刻	
petroleum	n.石油	
petrology	n.岩石學	
petty	a.瑣碎的；小心眼的	
petulance	n.發脾氣，性急，暴躁	
petulant	a.性急的，暴躁的	
phantom	n.鬼怪，幽靈；幻像	
pharmaceutical	a.製藥的	
pharmacology	n.藥理學，藥物學	
phenomena	n.(複數)現象；科學研究的現象	
phenomenal	a.顯著的，非凡的	
philanthropic	a.博愛的	
philatelist	n.集郵家	
philately	n.集郵	
philistine	n.庸人，市儈	
phlegmatic	a.冷靜的，冷淡的	
phoenix	n.鳳凰，永生或再生的象徵	
phonetic	a.語音的	
photosynthesis	n.光合作用	
physiological	a.生理的；生理學上的	
piano	a.(音樂)輕柔的	
pictorial	a.繪畫的；有圖片的，用圖片表示的	
piddling	a.瑣碎的，微不足道的	
pied	a.雜色的	
pierce	v.刺透；穿過	
piercing	a.(寒風)刺骨的；敏銳的	
pigment	n.天然色素；乾粉顏料	
pilgrim	n.朝聖客，香客	
pillar	n.柱子	
pillory	n.頸手枷；示眾，嘲弄	
pilot	n.飛行員；領航員；領導人	
pinch	v.捏，掐；n.一撮，一點	
pine	n.松樹；v.(因疾病等)憔悴；渴望	
pinnacle	n.尖塔；山峰，頂峰	
pinpoint	v.精確地找出或描述；a.非常精確的	
pious	a.虔誠的，盡責的	
piquant	a.辛辣的，開胃的；興奮的	
pique	n./v.(因自尊心受傷害而導致的)不悅，憤怒；v.冒犯	
pirate	n.海盜，剽竊者；v.盜印；掠奪	
pirouette	n./v.(舞蹈)腳尖立地的旋轉	
pistol	n.手槍	
pitch	n.瀝青，柏油；音調	
pitcher	n.有柄水罐	
pitfall	n.陷阱，未料到的危險或困難	
pith	n.精髓，要點	
pithiness	n.簡潔	
pithy	a.(講話或文章)簡練的	
pitiful	a.值得同情的，可憐的	
pittance	n.微薄的薪俸，少量的收入	
placate	v.撫慰，平息(憤怒)	
placebo	n.安慰劑	
placid	a.安靜的，平和的	
plagiarism	n.剽竊，抄襲	
plagiarize	v.剽竊，抄襲	
plague	n.瘟疫；討厭的人或物；v.煩擾	
plain	a.簡單的；清楚的；n.平原	
plaintiff	n.原告	
plaintive	a.可憐的，傷心的	
plait	n.髮辮；v.編成辮	
plane	n.鉋子；平面；v.刨	
planet	n.行星	
plangent	a.轟鳴的；悲哀的	
plankton	n.浮游生物	
plaque	n.匾；血小板	
plaster	n.灰泥，石膏；v.抹灰泥	
plateau	n.高原；平穩的狀態	
platitude	n.陳詞濫調	
platonic	a.理論的；純精神上的，沒有感官欲望的	
plaudit	v.喝彩，讚揚	
plausible	a.似是而非的，似乎合理的；嘴巧的	
plead	v.懇求，提出…為理由	
pleat	n.(衣服上的)褶	
pledge	n.誓言，保證；v.發誓	
plenitude	n.完全；大量	
plethora	n.過量，過剩	
pliable	a.易彎的，柔軟的	
pliant	a.易受影響的；易彎的	
plight	n.困境，苦境	
plinth	n.柱腳，底座	
plod	v.重步走；吃力地幹	
plot	n.情節；陰謀；策劃	
plough	n.犁；v.犁地	
ploy	n.花招，策略	
pluck	n.在困難面前足智多謀的勇氣，膽量；精力；v.拔毛；彈拉	
plumb	adv.精確地；v.深入瞭解；測水深	
plumber	n.管子工，鉛管工	
plume	n.羽毛；v.整理羽毛；搔首弄姿	
plummet	v.垂直或突然墜下	
plunder	v.搶劫，掠奪	
plunge	v.投入；俯衝	
plush	a.豪華的	
plutocracy	n.財閥統治	
pod	n.豆莢；v.剝掉(豆莢)	
podiatrist	n.足醫	
podium	n.講壇，指揮台	
poignant	a.傷心的；尖銳的	
poise	v.使相等，使平衡；n.泰然自若，鎮定	
poisonous	a.有毒的；有害的	
poke	v.刺，戳；嘲弄	
polar	a.地極的，兩極的；磁極的	
polarity	n.極端性，二極分化	
polarize	v.使…兩極分化	
polemic	n.爭論，論戰	
polemical	a.挑起論戰的	
polish	v.把…擦光亮，拋光；n.上光劑；(態度等)優雅	
poll	n.民意測驗；選舉投票	
pollen	n.花粉	
pollinate	v.給…授粉	
pollster	n.民意測驗家	
pomposity	n.自大的行為，傲慢，自命不凡	
pompous	a.自大的	
poncho	n.斗篷；雨衣	
ponder	v.仔細考慮	
ponderable	a.可估量的	
ponderous	a.笨重的，笨拙的	
pontifical	a.自以為是的；武斷的	
pontificate	v.自大武斷地做或說	
populace	n.民眾，老百姓	
populous	a.人口稠密的	
porcelain	n.瓷；瓷器	
porcupine	n.豪豬，箭豬	
pore	n.毛孔，氣孔	
porous	a.可滲透的；多孔的	
portentous	a.凶兆的，有危險的	
portfolio	n.資料夾；股份單	
portray	v.描繪，描述	
pose	v.擺姿勢；造作	
poseur	n.裝模作樣的人	
posit	v.斷定，認為	
posse	n.武裝團隊	
possessed	a.著迷的；瘋狂的	
poster	n.海報，招貼畫	
postpone	v.使延期，推遲	
postulate	v.假定；要求	
posture	n.姿勢，體態；態度；v.故作姿態	
potable	a.適於飲用的	
potation	n.暢飲；飲料	
potentate	n.統治者，當權者	
potential	a.潛在的，有可能性的	
potentiate	v.加強(力量，效果)	
potpourri	n.混雜；雜文集	
pottery	n.制陶；陶器	
pout	v.噘嘴，板臉	
practitioner	n.開業者；從事某種手藝者	
pragmatic	a.實際的，實用主義的	
prank	n.惡作劇，玩笑	
prate	v.瞎扯，胡說	
preach	v.傳教，講道	
preamble	n.前言，序言；先兆	
precarious	a.不穩的，危險的	
precede	v.在…之前，早於	
precept	n.箴言，格言	
precipice	n.懸崖	
precipitant	n.沉澱劑	
precipitate	v.加速，促成；a.魯莽的	
precipitation	n.降水(量)	
pr?cis	n.摘要，大綱	
precise	a.精確的	
preclude	v.避免，排除	
precocious	a.早熟的	
precursor	n.先驅，先兆	
predator	n.食肉動物	
predecessor	n.前任，前輩；原先的東西	
predestine	v.註定	
predicament	n.困境，窘境	
predilection	n.偏袒，愛好	
predisposition	n.傾向，癖性	
predominant	a.有勢力的	
predominate	v.支配，統治；佔優勢	
preeminent	a.出類拔萃的	
preempt	v.以先買權取得)；取代	
preen	v.整理羽毛；(人)打扮修飾	
preface	n.序言	
pregnant	a.懷孕的；充滿的	
prehistoric	a.史前的	
prejudice	n.偏見，成見；v.使產生偏見	
preliminary	a.預備的；初步的，開始的	
preliterate	a.文字出現以前的	
prelude	n.序幕，前奏	
premature	a.過早的，早熟的	
premeditate	v.預先想過，預謀	
premeditated	a.預謀的，事先計畫的	
premiere	n./v.首次公演	
premise	n.前提	
premium	n.保險費；獎金	
premonition	n.預感，預兆	
preoccupation	n.全神貫注；使人專注的東西	
preponderate	v.(重量上，重要性上)壓倒，超過	
preposition	n.介詞，前置詞	
preposterous	a.荒謬的	
prerequisite	n.先決條件	
prerogative	n.特權	
presage	n.預感；v.預示	
prescience	n.預知，先見	
prescribe	v.開處方；規定	
prescription	n.處方(上的藥)	
presentation	n.表演，介紹，描述	
presenter	n.主持人	
preservative	a.防腐的；n.防腐劑	
preside	v.擔任主席；負責；指揮	
press	v.擠壓	
pressing	a.緊迫的，迫切的；懇切要求的	
prestige	n.威信，威望，聲望	
prestigious	a.有名望的，有威信的	
presume	v.假定，認定	
presumption	n.冒昧，專橫；假定	
presupposition	n.預先假定，臆測	
pretend	v.假裝；裝扮	
pretension	n.自命不凡，誇耀	
pretentious	a.自抬身價的	
preternatural	a.異常的)；超自然的	
pretext	n.藉口	
prevail	v.戰勝；盛行	
prevaricate	v.支吾其詞，說謊	
preview	v./n.預演，預展	
previous	a.在先的，以前的	
prey	n.被捕食的動物	
prim	a.端莊的，整潔的	
primate	n.靈長類(動物)	
prime	n.全盛時期；a.首先的；最好的	
primp	v.(婦女)刻意打扮	
principal	a.主要的，重要的	
principle	n.原則，原理；道德準則	
priority	n.在先，居前；優先權	
pristine	a.太古的；純潔的；新鮮的	
privation	n.喪失，貧困	
privilege	n.特權，特別利益	
probe	v.探索，探測	
probity	n.剛直，正直	
proboscis	n.(象)長鼻；(昆蟲等)吸管	
proceeds	n.收入	
procession	n.行列；前進	
proclaim	v.宣告，宣佈；顯示	
proclamation	n.宣佈，公告	
procrastinate	v.耽擱，拖延	
proctor	n.代理人，學監	
procure	v.取得，獲得	
procurement	n.獲得，接收	
prod	v.刺，捅；激勵	
prodigal	a.揮霍的；n.揮霍者	
prodigious	a.巨大的	
prodigy	n.奇事；奇才	
produce	n.產品；農產品	
productivity	n.生產力；生產率	
profane	v.褻瀆，玷污	
proffer	n./v.獻出，贈送；提議，建議	
proficient	a.熟練的，精通的	
profile	n.外形；輪廓側面像	
profiteer	n.奸商，牟取暴利者	
profligate	a.揮金如土的；n.揮霍者	
profound	a.深的，深刻的；淵博的，深奧的	
profuse	a.很多的；浪費的	
progeny	n.後代，子女	
prognosis	n.預後，對疾病的發作及結果的預言	
prohibitive	a.抑制的；價格貴得買不起的	
projectile	n.拋射物，發射體	
projection	n.凸出物	
projector	n.電影放映機，幻燈機	
proliferate	v.繁殖；激增	
prolific	a.多產的，多結果的	
prolix	a.囉嗦的，冗長的	
prolixity	n.囉嗦	
prologue	n.開場白；序幕	
prolong	v.延長，拉長	
promenade	v./n.散步；開車兜風	
prominent	a.顯著的；著名的	
promote	v.提升；促進	
prompt	v.促使，激起；a.敏捷的，迅速的	
promulgate	v.頒佈(法令)；宣傳	
prone	a.俯臥的；傾向於…的	
pronounced	a.(觀點等)強硬的，明顯的	
prop	n.支撐物，靠山；v.支持	
propagate	v.繁殖；傳播	
propagation	n.繁殖	
propel	v.推進	
propeller	n.螺旋槳；推進器	
propensity	n.嗜好，習性	
prophecy	n.預言	
prophet	n.先知，預言家	
prophetic	a.先知的，預言的，預示的	
propitiate	v.討好；撫慰	
propitious	a.吉利的；順利的	
proposal	n.提案，建議	
proposition	n.看法；提議	
proprietary	a.私有的	
propriety	n.禮節；適當	
propulsion	n.推進力	
prosaic	a.單調的，無趣的	
proscribe	v.禁止	
prose	n.散文	
prosecute	v.告發，檢舉	
prosecution	n.起訴；實行，經營	
proselytize	v.使…皈依	
prospect	v.勘探；n.期望；前景	
prosperity	n.繁榮；幸運；健康	
prosperous	a.繁榮富強的	
prostrate	a.俯臥的；沮喪的；v.使下跪鞠躬	
protagonist	n.提議者，支持者	
protean	a.變化多端的，多變的	
protest	v./n.抗議，反對	
protocol	n.外交禮節；協議，草案	
prototype	n.原型；典型	
protract	v.延長，拖長	
protuberance	n.凸出，隆起	
protuberant	a.突出的，隆起的	
provenance	n.(藝術等的)出處，起源	
provender	n.(牛馬吃的)草料，糧秣	
provident	a.深謀遠慮的；節儉的	
providential	a.幸運的；恰到好處的	
provincial	a.偏狹的，粗俗的	
provision	n.(糧食)供應；(法律等)條款	
provisional	a.暫時的，臨時的	
provisory	a.有附帶條件的	
provocation	n.挑釁，激怒	
prowess	n.勇敢；不凡的能力	
prowl	v.潛行於，偷偷地漫遊	
proximate	a.最接近的，直接的	
prude	n.過分守禮的人	
prudence	n.謹慎，小心	
prudent	a.審慎的，三思而後行的，精明的	
prudish	a.過分守禮的，假道學的	
prune	n.梅幹；v.修剪	
pry	v.刺探；撬開	
pseudonym	n.假名，筆名	
psyche	n.心智，精神	
psychology	n.心理學，心理狀態	
publicize	v.宣傳，引人注意	
pucker	v.起皺；n.皺褶	
puckish	a.淘氣的	
puddle	n.水坑，窪	
puerile	a.幼稚的；兒童的	
pugilism	n.拳擊，搏擊	
pugilist	n.拳擊手，拳師	
pugnacious	a.好鬥的	
puissance	n.權力	
puissant	a.強有力的，強大的	
pulchritude	n.美麗	
pullet	n.小母雞	
pulley	n.滑輪；滑車	
pulp	n.果肉醬；紙漿	
pulse	v.搏動，跳動；n.脈搏；脈衝	
pulverize	v.壓成細粉；徹底擊敗	
pun	n.雙關語	
punch	v.以拳猛擊；打洞	
punctilious	a.謹小慎微的	
puncture	v.刺穿，刺破；n.刺孔，穿孔	
pundit	n.權威人士，專家	
pungent	a.味道刺激的；苛刻的	
puny	a.弱小的，發育不良的	
purchase	n.支點(阻止東西下滑)	
purgative	n.瀉藥	
purgatory	n.煉獄；受苦受難的地方	
purge	v.清洗，洗滌	
purify	v.使潔淨，淨化	
purity	n.純潔，純淨；純度	
purlieu	n.(常作複數)鄰近地區	
purloin	v.偷竊	
purported	a.謠傳的，聲張的，號稱的	
pursue	v.追趕，追求，追蹤	
purvey	v.(大量)供給，供應	
pusillanimous	a.膽小的	
pylon	n.高壓電線架；橋塔	
pyre	n.火葬用的柴堆	
quack	n.冒充內行之人；庸醫	
quaff	v.痛飲，暢飲	
quail	v.畏懼，顫抖	
quaint	a.離奇有趣的	
qualified	a.有資格的；有限制的	
qualms	n.疑慮(尤指有關良心問題的)	
quandary	n.困惑，進退兩難	
quantum	n.量子；定量	
quarantine	n.隔離檢疫期，隔離	
quarry	n.獵物	
quartet	n.四重奏，四重唱	
quash	v.鎮壓；取消	
quaver	v.發顫音，顫抖；n.顫音	
quay	n.碼頭	
quell	v.制止，鎮壓	
quench	v.熄滅(火)；抑制(欲望)	
querulous	a.抱怨的，多牢騷的	
quest	v.搜尋，探求；n.探求	
queue	v.排隊；n.長隊	
quibble	n.遁詞；吹毛求疵的反對意見	
quiescent	a.不動的，靜止的	
quill	n.(豪豬等動物的)刺	
quirk	n.奇事；怪癖	
quisling	n.賣國賊，內奸	
quiver	n.箭筒，箭囊	
quixotic	a.不切實際的，空想的	
quota	n.定額，配額	
quote	v.引用，引述	
quotidian	a.每日的；平凡的	
rabble	n.烏合之眾；下等人	
rabid	a.患狂犬病的；失去理性的	
rabies	n.狂犬病；恐水病	
raconteur	n.善於講故事的人	
racy	a.活潑的，生動的	
radius	n.半徑	
raffish	a.粗俗的；俗豔的	
raffle	n.(尤指為公益事業舉辦的)抽獎售物(活動)	
rafter	n.椽子	
rag	n.舊布，碎布；破舊衣服	
rage	n.盛怒；v.激怒	
ragged	a.破爛的	
ragtime	n.拉格泰姆音樂；a.使人發笑的，滑稽的	
raid	n.突然襲擊	
rail	n.欄杆；鐵軌；v.咒?，猛烈指責	
raisin	n.葡萄乾	
rakish	a.瀟灑的；放蕩的	
rally	v.召集，集會；n.召集；集會	
ram	n.公羊；撞錘，猛擊；填塞	
ramble	n./v.漫步	
rambunctious	a.騷亂的；(興奮)控制不了的	
ramify	v.分支，分叉	
rampage	v.狂暴地亂沖；n.暴怒	
rampant	a.蔓生的，猖獗的	
rampart	n.壁壘；城牆	
ramshackle	a.搖搖欲墜的	
rancid	a.不新鮮的，變味的	
rancor	n.深仇，怨恨	
random	a.沒有明確目的、計畫或者目標的；偶然的，隨便的	
ranger	n.森林管理員；巡邏騎警	
rankle	v.怨恨；激怒	
ransom	n.贖金；贖身；v.贖回	
rant	v.咆哮；口出狂言	
rapacious	a.強奪的，貪婪的	
rapids	n.急流，湍流	
rapport	n.和睦，意見一致	
rapprochement	n.和好，和睦	
rapt	a.專心致志的，全神貫注的	
rarefaction	n.稀薄	
raspy	a.(聲音)刺耳的；惱人的	
ratification	n.正式批准	
ratiocination	n.推理；推論	
ration	n.定量配給；v.配給	
rational	a.理性的；合理的	
rattle	v.使格格作響；使慌亂	
raucous	a.(聲音)沙啞的，粗糙的	
ravage	v.摧毀，使荒廢	
rave	n.熱切讚揚；v.狂語	
ravel	v.糾纏，糾結；拆開，拆散	
ravenous	a.餓極了的，貪婪的	
ravine	n.深谷，峽谷	
ravishing	a.令人陶醉的	
raze	v.徹底破壞	
razor	n.剃刀，刮胡刀	
reactant	n.反應物	
reactionary	a.保守的，反動的	
readily	adv.不遲疑地；迅速地，輕易地	
ready	a.機敏的，迅速的	
reagent	n.試劑(導致化學反應)	
realign	v.重新組合(排列)	
realm	n.王國；領域，範圍	
ream	n.令(紙張的計數單位)	
reap	v.收割，收穫	
reaper	n.收割者	
rebate	n.折扣，回扣	
rebellious	a.反抗的，難控制的	
rebuff	v.斷然拒絕	
rebuke	v.指責，譴責	
rebus	n.(以音、畫等提示的)字謎，畫謎	
rebuttal	n.反駁，反證	
recalcitrant	a.頑抗的	
recall	v.回想，回憶起；收回；n.喚回	
recant	v.改變，放棄(以前的信仰)	
recantation	n.改變宗教信仰	
recapitulate	v.扼要重述	
recast	v.重鑄；更換演員	
recede	v.後退，收回(諾言)	
receipt	n.收到，接到；發票，收據	
receptacle	n.容器	
receptive	a.善於接受的；從善如流的	
recess	n.壁凹(牆上裝的架子、櫃子等凹處)；休假	
recession	n.經濟蕭條時期；撤回，退回	
recessive	a.隱性遺傳的；後退的	
recipe	n.食譜	
recipient	n.接受者，收受者	
reciprocal	a.相互的，互惠的	
reciprocate	v.回報，答謝	
recital	n.獨奏；吟誦	
reclaim	v.糾正；開墾(土地)	
recluse	n.隱士；a.隱居的	
recoil	v.退卻，退縮	
recollection	n.記憶力；記憶中的往事	
recombine	v.重組，再結合	
recompense	v.報酬，賠償	
reconcile	v.和解，調和	
recondite	a.深奧的	
reconnaissance	n.偵察，預先探索	
reconstitute	v.再組成；用水泡	
recourse	n.求助，依靠	
recruit	n.新兵；新成員；v.徵募	
rectangle	n.長方形，矩形	
rectify	v.改正，調正；提純	
rectitude	n.誠實，正直	
recumbent	a.側臥的；休息的	
recuperate	v.恢復(健康)，復原	
redeem	v.贖罪	
redemptive	a.贖回的，救贖的，救世的	
redirect	v.改寄(信件)；改變方向	
redistribution	n.重新分配	
redolent	a.芬芳的，芳香的	
redoubtable	a.可敬畏的	
redress	n.改正，修正	
redundancy	n.過剩；備份；似乎多餘其實重要的後備力量	
redundant	a.累贅的，多餘的	
reed	n.蘆葦；簧片	
reek	v.發臭味；冒煙	
reel	n.卷軸，旋轉；v.卷…於軸上	
refectory	n.(學院)餐廳，食堂	
referee	n.裁判員；仲裁者	
refinery	n.提煉廠，精煉廠	
reflect	v.反射；仔細考慮	
refraction	n.折射	
refractory	a.倔強的；反應遲鈍的	
refrain	v.抑制；n.歌曲的反複句，疊句	
refresh	v.消除…的疲勞，使精神振作	
refugee	n.難民，流亡者	
refulgent	a.輝煌的，燦爛的	
refurbish	v.刷新，擦亮	
refute	v.駁斥	
regale	v.款待；使…享受	
regime	n.政權，政治制度	
regress	v.使倒退，復原，逆行	
regressive	a.退步的，退化的	
regulate	v.管制；調整	
rehabilitate	v.修復，恢復(職業等)	
rehearsal	n.排演，演習	
rehearse	v.排練，預演；詳述	
reign	n.統治時期；王朝；領域	
reimburse	v.償還	
rein	n.韁繩；v.控制	
reinforce	v.加強力量，增援	
reinstate	v.恢復(原職)	
reiterate	v.重申，反復地說	
rejoice	v.喜歡，高興	
rejuvenate	v.使返老還童	
relapse	n.舊病復發；再惡化；v.舊病復發，再惡化	
relate	v.講述；有關聯	
relaxation	n.鬆弛，消遣	
release	v.釋放，放出；n.釋放	
relegate	v.降級，貶謫	
relent	v.動憐憫心；減弱	
relenting	a.減弱的，憐憫的	
relentless	a.無情的，殘酷的	
relevance	n.相關	
reliance	n.信賴，信任	
relic	n.遺物，遺跡	
relieved	a.寬慰的，如釋重負的	
religion	n.宗教，信仰	
relinquish	v.放棄，廢除	
relish	n.味道；喜好；v.喜好，享受	
remainder	n.剩餘物	
remains	n.遺址，廢墟	
reminder	n.提醒人記憶之物	
reminisce	v.追憶，懷舊	
remiss	a.疏忽的，不留心的	
remnant	n.殘餘物；零頭布料	
remorse	n.懊悔，悔恨	
remove	v.移走；脫掉；遷移	
remunerative	a.報酬高的，有利潤的	
rend	v.撕裂；猛拉	
render	v.呈遞，表現；提供	
rendering	n.演出；翻譯	
rendezvous	n.約會；約會地點	
renegade	n.叛教者，叛徒	
renege	v.背信，違約	
renounce	v.(正式)放棄	
renovate	v.修復，裝修，翻新	
renown	n.名望，聲譽	
rent	n.裂縫；(意見)分歧	
reparable	a.能補救的，可挽回的	
reparation	n.賠償，補償	
repartee	n.機靈的回答	
repatriate	v.(自異國)遣返	
repeal	v.廢除(法律)	
repel	v.擊退，使…反感	
repellent	a.令人厭惡的	
repercussion	n.反響；影響；回聲	
repertoire	n.(劇團等)常備劇碼	
repine	v.不滿，心中抱怨	
replenish	v.補充，再裝滿	
replete	a.飽滿的，塞滿的	
reportorial	a.記者的；記實的	
repose	n./v.躺著休息，安睡	
reprehend	v.譴責，責難	
reprehensible	a.應受譴責的	
repressed	a.被壓制的，被壓抑的	
reprieve	v.緩刑，暫時解救；n.緩刑，暫時解救	
reprimand	n.訓誡，譴責；v.訓誡，譴責	
reprisal	n.(政治或軍事的)報復	
reprise	n.(音樂劇中)樂曲的重複；重複	
reproach	n.譴責，責?	
reprobate	v.譴責，指責；adj./n.墮落的(人)	
reproof	n.責斥，責備	
reprove	v.責?，申斥	
reptile	n.爬行動物；卑鄙的人	
reptilian	a.爬蟲類的；卑下的	
repudiate	v.拒絕，拋棄	
repugnance	n.嫌惡，反感	
repugnant	a.令人厭惡的	
repulse	v.驅逐，擊退；厭惡；n.驅逐，擊退，厭惡	
repulsion	n.厭惡，反感；排斥力	
reputation	n.名聲	
repute	n.名聲，名譽	
request	n.要求，請求；v.要求，請求	
requisite	n.必需物；a.必要的	
requite	v.報答；報復	
rescind	v.廢除，取消	
rescission	n.廢除	
rescue	n./v.解救；把…從法律監管下強行奪回	
resent	v.憎惡，憤恨	
resentment	n.憤恨，怨恨	
reserve	n.儲備(物)，儲藏量；緘默，謹慎；v.保留，儲備，預訂	
reside	v.居住	
resident	n.居民；a.定居的，常駐的	
residual	a.殘餘的，剩餘的	
residue	n.剩餘	
resignation	n.聽從，順從；辭職	
resigned	a.逆來順受的，順從的	
resilience	n.彈性，彈力	
resilient	a.有彈性的；能恢復活力的，適應力強的	
resin	n.樹脂	
resonant	a.(聲音)洪亮的；共鳴的	
resort	n.度假勝地	
resound	v.回蕩著聲音；鳴響	
resourceful	a.機智的	
respiration	n.呼吸	
respite	n.休息；暫緩	
resplendent	a.華麗的，輝煌的	
respondent	n.被告	
response	n.反應，回應，回答	
responsive	a.敏感的，反應快的	
responsiveness	n.應答，回應	
restitution	n.歸償；賠償	
restive	a.不安靜的，不安寧的	
restiveness	n.倔強；難以駕禦	
restless	a.不停的；不安靜的	
restore	v.使回復，恢復；修復，修補	
restored	a.恢復的，複修的	
restrain	v.克制，抑制	
restraint	n.克制	
resume	v.重新開始，繼續	
resurgence	n.再起，復活，再現	
resurrect	v.使復活；復興	
resuscitate	v.使復活，使蘇醒	
retail	v.零售；n.零售	
retain	v.保留，保持；留住	
retainer	n.侍從	
retaliate	v.報復，反擊	
retaliation	n.報復	
retard	v.妨礙；減速	
reticent	a.沉默不語的	
retinue	n.侍從，隨員團	
retiring	a.隱居的，不喜歡社交的	
retort	v.反駁	
retouch	v.修描；潤色	
retrace	v.回顧，追想	
retract	v.縮回，收回	
retreat	n./v.撤退；隱居處	
retrench	v.節省，緊縮費用	
retribution	n.報應，懲罰	
retrieve	v./n.尋回，取回；挽回(錯誤)	
revealing	a.暴露的，裸露的；揭露性的	
revelation	n.顯示；洩露的事實	
revelry	n.狂歡	
revenge	n.報復，報仇	
revenue	n.總收入；國家的稅收收入	
reverberate	v.起回聲，反響	
revere	v.尊敬	
reverie	n.幻想，夢幻曲	
reverse	n.反面；相反；v.倒車；反轉	
revert	v.恢復，回復到；重新考慮	
revile	v.辱?，惡言相向	
revise	n./v.改變，修正	
revitalize	v.使重新充滿活力	
revive	v.使蘇醒；再流	
revolt	v.叛亂，造反；反感	
revue	n.時事諷刺劇	
reward	n.酬報，獎賞；v.酬謝，獎賞	
rewarding	a.有益的，值得做的	
rhetoric	n.修辭學，浮誇的言語	
rhinestone	n.水晶石，萊茵石	
rhubarb	n.(植物)大黃；v./n.喧鬧爭吵	
rhyme	n.押韻；v.押韻	
rhythmic	a.有節奏的	
rib	n.肋骨；傘骨	
ribald	a.下流的，粗鄙的	
rickety	a.不牢靠的，搖搖欲墜的	
riddle	n.謎語	
rider	n.騎手；附文，附件	
ridge	n.脊(如屋脊，山脊等)；隆起物	
ridicule	n.奚落；v.嘲笑	
rife	a.流行的，普遍的	
rifle	n.步槍；v.搶劫	
rift	n.裂口，斷裂；矛盾	
rig	v.欺騙，舞弊，偽造	
rigid	a.硬性的，剛硬的	
rigor	n.嚴酷；嚴格，苛刻；嚴密，精確	
rile	v.使…惱火，激怒	
rind	n.(西瓜等)外皮	
ringlet	n.卷髮	
riot	v.參加暴動	
riotous	a.暴亂的；蠻橫的	
ripen	v.使成熟	
ripple	v.起漣漪；n.細浪，漣漪	
rite	n.(宗教的)儀式	
ritual	n.儀式，例行習慣	
rival	n.競爭者，對手；v.與…匹敵	
rivalry	n.競爭，對抗	
rive	v.撕開，分裂	
riven	a.撕裂的，分裂的	
rivet	n.鉚釘；v.吸引(注意力)	
riveting	a.非常精彩的	
rivulet	n.小溪，小河	
robe	n.長袍，禮服	
robust	a.健壯的	
roe	n.魚卵	
roil	v.煽動，攪渾	
rookie	n.新兵，新手	
roster	n.值班表，花名冊	
rostrum	n.講臺，講壇	
rotate	v.旋轉，轉動；輪流，交替	
rotten	a.腐敗的；糟糕的	
roughen	v.變得粗糙，變得不平	
royalty	n.版稅	
rubicund	a.(臉色)紅潤的	
rudder	n.船舵；領導者	
rudimentary	a.初步的，未充分發展的	
rue	n.後悔，遺憾	
ruffian	n.惡棍，歹徒；a.殘暴的	
ruffle	v.弄皺；激怒；n.皺邊(裝飾衣服)	
ruminant	a.(動物)反芻的；沉思的	
rumple	v.弄皺，弄亂	
rung	n.梯子橫擋，梯級	
runic	a.北歐古代文字的；神秘的	
rupture	n./v.破裂，斷裂	
rural	a.鄉村的	
ruse	n.騙術，詭計	
rustic	a.鄉村的，鄉土氣的	
ruthlessness	n.無情，殘忍	
sabotage	n.陰謀破壞，顛覆活動	
saboteur	n.從事破壞活動者	
saccharin	n.糖精	
sacred	a.神聖的，莊嚴的	
sacrifice	n.犧牲；v.宰牲祭神	
sacrilege	n.褻瀆，冒犯神靈	
sacrilegious	a.褻瀆神聖的	
sadden	v.使傷心，使悲哀	
saddle	n.鞍，馬鞍	
safeguard	n.防範措施	
sagacious	a.聰明的，睿智的	
sage	a.智慧的；n.智者	
saintly	a.聖徒似的，極為聖潔的	
salient	a.顯著的，突出的	
saliva	n.唾液，口水	
salmon	n.大麻哈魚；鮮肉色	
salubrious	a.有益健康的	
salutary	a.有益的，有益健康的	
salutation	n.招呼，致意，敬禮	
salute	v.行舉手禮；向…致意；n.敬禮	
salvage	n./v.(從災難中)搶救，海上救助	
salve	n.藥膏；v.減輕，緩和	
sampler	n.刺繡花樣；取樣員	
sanctify	v.使神聖	
sanctimonious	a.假裝神聖的	
sanction	n./v.批准，認可	
sandal	n.涼鞋，拖鞋	
sane	a.神志清楚的，明智的	
sanguine	a.樂觀的	
sanity	n.神志清楚	
sap	n.樹液；活力；v.消弱，耗盡	
sapient	a.有智慧的	
sapphire	n.青石，藍寶石；a.天藍色的	
sarcastic	a.諷刺的	
sartorial	a.裁縫的，縫製的	
sash	n.肩帶	
sate	v.使心滿意足，使厭膩	
satiated	a.；厭倦的，生膩的	
satire	n.諷刺(作品)	
satirize	v.諷刺	
saturate	v.浸透；使充滿	
saturated	a.滲透的，飽和的	
saturnine	a.憂鬱的，陰沉的	
saunter	n./v.閒逛，漫步	
savage	a.兇猛的，野蠻的	
savant	n.博學之士，大學士	
savvy	a.有見識和精明能幹的	
sawdust	n.鋸屑	
scabbard	n.(刀劍)鞘	
scad	n.許多，大量	
scaffold	n.腳手架(造房時搭的架子)	
scalding	a.滾燙的	
scale	n.魚鱗；(音樂)音階	
scalpel	n.外科手術刀，解剖刀	
scandal	n.醜聞；惡意誹謗	
scant	a.不足的，缺乏的	
scarcity	n.不足，缺乏	
scarf	n.圍巾，披肩	
scathing	a.苛刻的，嚴厲的	
scatter	v.散開，驅散	
scenario	n.劇情說明書；劇本	
schematic	a.綱要的，圖解的	
schematize	v.扼要表示	
scheme	n.陰謀；(作品等)體系，結構	
schism	n.組織分裂	
school	n.魚群	
scion	n.嫩芽；子孫	
scissor	n.剪刀	
scoff	v.嘲笑；狼吞虎嚥；n.嘲笑，笑柄	
scoop	n.小鏟，勺子；v.(用勺子)取出，舀出	
scope	n.眼界；範圍	
scorch	v.烤焦，燒焦	
score	n.樂譜	
scorn	n.輕蔑；v.輕蔑，瞧不起	
scorpion	n.蠍子	
scotch	v.鎮壓，粉碎	
scourge	n.鞭笞；磨難；v.鞭笞，磨難	
scowl	n.怒容；v.生氣地皺眉，怒視	
scrap	n.小片，碎屑；v.廢棄	
scrappy	a.碎片的；好鬥的；堅毅的	
scrawl	v.潦草地寫，亂塗	
screw	n.螺絲釘，螺旋；吝嗇鬼	
screwdriver	n.螺絲起子；改錐	
scribble	v.亂寫，亂塗	
script	n.劇本，腳本	
scripture	n.經文，聖典	
scroll	n.卷軸，紙卷；畫卷	
scrub	n.矮樹叢；身體矮小的人；v.用力擦洗	
scruple	n.顧忌，遲疑；v.顧忌	
scrutable	a.可以理解的	
scrutinize	v.詳細檢查；細讀	
scuff	v.拖著腳走	
sculpt	v.雕刻	
sculptor	n.雕刻家	
scurrilous	a.下流的	
scurry	v.急跑，疾行	
scurvy	a.卑鄙的，可鄙的	
scythe	n.大鐮刀	
seam	n.縫，接縫	
seamy	a.骯髒的，惡劣的	
sear	v.(以烈火)燒灼	
seasoned	a.有經驗的，訓練有素的	
seasoning	n.調味品，佐料	
secede	v.正式脫離或退出(組織)	
secrete	v.隱藏；分泌	
secretive	a.守口如瓶的	
secular	a.世俗的，塵世的	
secure	a.安全的；穩固的；v.固定；使安全	
securities	n.證券	
sedate	a.鎮靜的	
sedative	a.(藥物)鎮靜的；n.鎮靜劑	
sedentary	a.久坐的	
sediment	n.沉澱物，渣	
sedulity	n.勤奮，勤勉	
sedulous	a.聚精會神的，勤勉的	
seedling	n.幼苗	
seemly	a.得體的，適宜的	
seep	v.(液體等)滲漏	
seethe	v.沸騰，洶湧	
segment	n.部分	
seine	n.拉網，大捕魚網	
seismic	a.地震的	
semblance	n.外貌；相似	
seminal	a.有創意的	
seminary	n.神學院	
sensation	n.知覺；轟動(的事)	
sensible	a.明智的；可感覺到的	
sensitive	a.敏感的	
sensitivity	n.敏感，靈敏性	
sensitization	n.敏化	
sentient	a.有知覺的；知悉的	
sentiment	n.多愁善感；思想感情	
sentinel	n.哨兵，衛兵	
separate	v.使分開；a.不同的；獨自的	
septic	a.受感染的，腐敗的	
sepulchral	a.墳墓的；陰深的	
sequential	a.連續的，一連串的	
sequester	v.(使)隱退；使隔離	
seraphic	a.如天使般的，美麗的	
sere	a.乾枯的，凋萎的	
serene	a.清澈的，晴朗的，安靜的	
serial	a.連續的，一系列的	
sermon	n.佈道；說教，訓誡	
serrate	a.鋸齒狀的	
serrated	a.呈鋸齒狀的	
serried	a.密集的	
serviceable	a.可用的，耐用的	
servile	a.奴性的，百依百順的	
servitude	n.奴役，勞役	
setback	n.挫折	
settle	v.安置於；決定；棲息	
settled	a.固定的	
sever	v.切斷，脫離	
severe	a.嚴格的；兇猛的	
sewer	n.排水溝，下水道	
sextant	n.六分儀(航海定向儀器)	
shackle	n.腳鐐，枷鎖	
shale	n.葉岩(一種由似泥土細粒的沉澱物層組成的易分裂的岩石)	
sham	n.虛假；v.偽裝	
shambles	n.淩亂景象，雜亂無章	
shard	n.(陶器等)碎片	
shattered	a.粉碎的；破壞的	
shavings	n.刨花	
shear	v.剪(羊毛)，剪髮	
sheath	n.(刀、劍)鞘、套	
sheathe	v.將(刀，劍等)插入鞘	
shed	v.流出(眼淚等)；脫落(葉子)	
sheer	a.完全的；陡峭的；極薄的	
shell	n.貝殼；炮彈；v.剝去…的殼	
shelter	n.掩蔽處，掩蔽；v.庇護，保護	
shelve	v.擱置	
sheriff	n.警長，縣治安官	
shield	n.盾；v.掩護，遮擋	
shiftiness	n.奸詐	
shiftless	a.沒有決斷力的；偷懶的；無能的	
shingle	n.木瓦，屋頂板；木質小招牌	
shipshape	a.整潔的，井然有序的	
shirk	v.逃避，規避	
shoal	n.淺灘，淺水處；一群(魚等)；a.水淺的	
shoddy	n.劣質的，冒充好貨的	
shoot	n.嫩芽，新芽	
shoplift	v.在商店裡偷竊貨品	
shopworn	a.在商店中陳列舊了的	
shoulder	n.肩；路肩	
shove	v.推擠，猛推	
shrewd	a.判斷敏捷的，精明的	
shriek	v.尖叫	
shrine	n.神龕，聖地	
shrink	v.收縮，皺縮	
shroud	n.壽衣；遮蔽物；v.覆蓋	
shrub	n.灌木	
shrug	v.聳肩(表示懷疑等)	
shuck	n.(植物的)殼，夾；無用之物	
shudder	v./n.戰慄，發抖	
shun	v.避免，閃避	
shunt	v.使(火車)轉到另一軌道，轉移方向	
sibilant	a.發出??聲的	
sibling	n.兄弟或姊妹	
sibyl	n.女預言家，女先知	
sidereal	a.恒星的	
sideshow	n.雜耍，穿插表演	
sidestep	v.橫跨一步以躲避；回避	
siege	n.包圍，圍攻	
sift	v.篩，過濾	
signal	n.信號；v.發信號；a.顯著的	
significant	a.相當數量的；意義重大的	
signify	v.表示；有重要性	
sill	n.門檻；窗臺	
silt	n.淤泥，淤沙	
silversmith	n.銀匠	
simper	v.癡笑，傻笑	
simpleton	n.笨蛋	
simulate	v.假裝，模仿	
simultaneous	a.同時發生的	
sincere	a.誠實的，正直的；真摯的，純淨的	
sinecure	n.掛名差事，閒職	
sinew	n.腱，肌肉)；力量	
singe	v.(輕微地)燒焦，燙焦	
singularity	n.獨特；奇點(天文學上密度無窮大、體積無窮小的點)	
sinuous	a.蜿蜒的，迂回的	
sip	v.啜飲	
siren	n.汽笛，警報器	
skeleton	n.骨架，骨骼；提綱	
sketchy	a.概略的，粗略的	
skew	a.不直的，歪斜的	
skewer	n.(烤肉用的)穿肉杆；v.用杆穿好	
skiff	n.輕舟，小船	
skillet	n.煎鍋	
skim	v.從液體表面撇去；流覽，略讀	
skimp	v.節省花費	
skinflint	n.吝嗇鬼	
skirmish	n.小戰，小爭吵	
skirt	v.環繞，逃避	
skit	n.幽默諷刺短劇	
skyscraper	n.摩天大樓	
slab	n.厚板，厚塊	
slack	a.懶散的，懈怠的；(繩)鬆弛的；v.鬆懈，怠惰	
slacken	v.(使)鬆弛，放鬆	
slag	n.爐渣，礦渣	
slake	v.解渴，消渴	
slander	v./n.誹謗，詆毀	
slanderous	a.誹謗的	
slant	v.傾斜；n.斜面；看法	
slate	n.石板；候選人名單；v.提名	
slaughter	v./n.屠殺，屠宰	
sleigh	n.(馬拉的)雪橇	
slew	v.(使)旋轉；n.大量	
slice	v.切成片；n.薄片	
slick	a.熟練的；圓滑的；光滑的	
slight	a.微小的；n./v.輕蔑	
slippage	n.滑動，下降	
slippery	a.滑的；狡猾的	
slipshod	a.馬虎的，草率的	
slither	v.(蛇)滑動，扭動前進	
sliver	n.長條；v.裂成細片	
sloppy	a.邋遢的，不整潔的	
slot	n.狹孔	
sloth	n.懶惰；樹獺(一種動物)	
slouch	n.沒精打采的樣子；v.沒精打采地坐(站、走)	
slough	v.(蛇等)蛻皮；n.(蛇等的)蛻皮	
sluggard	n.懶鬼	
sluice	n.水門，水閘；v.沖洗	
slumber	v.睡眠，安睡；n.安睡	
slur	v.含糊不清地講	
slurp	v.大聲地啜喝	
sly	a.狡猾的，鬼鬼祟祟的	
smarmy	a.虛情假意的	
smart	n.痛苦；a.時髦的；聰明的	
smattering	n.略知；少數	
smear	n.油漬，污點；v.弄髒，玷污	
smirk	v.假笑，得意地笑	
smooth	a.光滑的；平穩的；v.弄平，使光滑；消除	
smother	v.覆蓋；(使)悶死	
smudge	n.漬痕；v.弄髒	
smug	a.自滿的，自命不凡的	
smuggle	v.走私，私運	
snare	n.羅網，陷阱	
snarl	n./v.糾纏，混亂	
snatch	n./v.強奪，攫取	
sneaking	a.秘密的，不公開的	
sneer	v.嘲笑，鄙視	
snide	a.諷刺的，含沙射影的	
snip	v.剪斷	
snitch	v.告密；偷	
snobbish	a.勢利眼的；假充紳士的	
snowdrift	n.雪堆	
snub	v.冷落，不理睬	
snug	a.溫暖的，舒適的	
soak	v.浸泡，滲透	
soar	v.高飛，翱翔；猛增	
sober	a.清醒的；莊重的	
sobriety	n.節制，莊重	
sock	v.重擊，痛打	
sod	n.草地，草坪	
sodden	a.浸透了的	
soggy	a.濕透的	
soil	n./v.弄髒，汙損	
solace	n.安慰，慰藉	
solder	v.焊接，焊合	
solemn	a.嚴肅的，莊嚴的；黑色的	
solemnity	n.莊嚴，肅穆	
solicit	v.懇求；教唆	
solicitous	a.熱切的；掛念的	
solicitude	n.關懷，牽掛	
solidarity	n.團結，一致	
solidify	v.鞏固，(使)凝固，(使)團結	
solitary	a.孤獨的；n.隱士	
solitude	n.孤獨	
solo	a.單獨的；n.獨唱	
soluble	a.可溶的；可以解決的	
solvent	a.有償債能力的；n.溶劑	
somatic	a.肉體的	
somber	a.憂鬱的；陰暗的	
sonata	n.奏鳴曲	
sonnet	n.十四行詩	
soot	n.黑煙灰，油煙	
soothe	v.撫慰；減輕	
sop	n.泡過的食品；安慰品	
sophism	n.詭辯；詭辯法(術)	
sophisticated	a.老於世故的；(儀器)精密的	
sophistication	n.詭辯，強詞奪理；久經世故，老練，精明	
sophistry	n.詭辯	
soporific	a.催眠的；n.安眠藥	
sopping	a.渾身濕透的	
sorcery	n.巫術，魔法	
sordid	a.卑鄙的；骯髒的	
souvenir	n.紀念品	
sovereign	n.最高統治者，元首	
sovereignty	n.主權，統治權	
sow	n.母豬；v.播種	
spackle	n.填泥料(用以填塞裂縫和洞穴)	
span	n.跨度；兩個界限間的距離	
spank	v.打，拍打(在屁股上)	
sparing	a.節儉的	
spark	n.火花，火星	
sparring	n.拳擊，爭鬥	
sparse	a.稀少的，貧乏的	
spartan	a.簡樸的；刻苦的	
spat	n.口角，小爭論	
spate	n.大批，大量；(水)氾濫	
spatial	a.有關空間的，在空間的	
spatula	n.(調拌等用的)抹刀	
spawn	n.(魚等)卵子；v.大量生產	
spear	n.矛；嫩葉；v.刺戳	
specialize	v.專門研究	
specialized	a.專門的	
specifics	n.細小問題，細節	
specimen	n.範例，樣品，標本	
specious	a.似是而非的；華而不實的	
speck	n.斑點；少量	
spectacular	a.壯觀的，引人入勝的	
spectator	n.觀眾，觀看者	
specter	n.鬼魂，幽靈；恐懼	
spectral	a.幽靈的	
spectrum	n.光譜；範圍	
speculate	v.沉思，思索；投機	
speculative	a.投機的；推理的，思索的	
spell	n.連續的一段時間	
spendthrift	adj./n.揮金如土的(人)	
spike	n.長釘，大釘	
spin	v.旋轉；紡，紡紗；n.旋轉	
spindly	a.細長的，纖弱的	
spineless	a.沒骨氣的，懦弱的	
spiny	a.針狀的；多刺的，棘手的	
spire	n.(教堂)尖頂	
spiritual	a.精神的	
spite	n.怨恨，惡意	
spleen	n.怨怒	
splendor	n.壯麗；輝煌	
splice	v.接合，銜接	
splint	n.(固定斷骨的)夾板，托板	
split	n./v.分裂，裂開	
splurge	n.炫耀，擺闊	
spoil	v.損壞，破壞；溺愛	
spoke	n.(車輪上)輻條	
spongy	a.像海綿的；不堅實的	
spontaneity	n.自然，自發	
spontaneous	a.自發的；自然的	
spoof	v.揶揄，嘲諷	
sporadic	a.不定時發生的	
sport	v.炫耀，賣弄	
sprain	v.扭傷	
sprawling	a.植物蔓生的，(城市)無計畫地擴展的	
sprig	n.嫩枝，小枝	
sprightly	a.愉快的，活潑的	
sprout	v.長出，萌芽；n.嫩芽	
spruce	n.雲杉；a.整潔的	
spur	v.刺激，激勵；用馬刺刺馬	
spurious	a.假的；偽造的	
squabble	n.爭吵	
squalid	a.污穢的，骯髒的	
squall	n.短暫、突然且猛烈的風暴；短暫的騷動	
squalor	n.不潔，污穢	
squander	v.浪費，揮霍	
square	v.一致，符合；結清	
squash	v.壓碎，擠壓；n.南瓜	
squat	v.蹲下；a.矮胖的	
squeeze	v.壓，擠；n.壓榨，緊握	
squelch	v.壓制，鎮壓	
squint	v.斜視	
squirrel	n.松鼠	
staccato	a.(音樂)斷音的，不連貫的	
stagnant	a.停滯的	
staid	a.穩重的，沉著的	
stain	v.玷污；染色	
stake	n.柱樁；賭注	
stale	a.不新鮮的，陳腐的	
stalemate	n.和棋局面，僵局	
stalk	v.隱伏跟蹤(獵物)	
stall	v.使停止，使延遲	
stalwart	a.健壯的，堅定的	
stammer	v.口吃，結巴	
stamp	v./n.跺腳；在…上蓋印	
stance	n.站姿；立場	
stanch	v.制止(血液)，止住	
stanza	n.(詩)節，段	
staple	n.主要產品	
starchy	a.含澱粉的；刻板的	
stark	a.(外表)僵硬的；完全的	
startle	v.使吃驚	
stasis	n.停滯	
static	a.靜態的，呆板的	
stationary	a.靜止的，不動的	
statuary	n.雕像；雕塑藝術	
stature	n.身高，身材	
status	n.身分，地位	
statute	n.法規，法令	
statutory	a.法定的；受法令所約束的	
steadfast	a.忠實的；不變的	
stealth	n.秘密的行動	
steep	v.浸泡，浸透	
steer	v.操舵，駕駛；n.公牛，食用牛	
stellar	a.星的，星球的	
stem	n.(植物的)莖，葉柄；v.阻止，遏制(水流等)	
stench	n.臭氣，惡臭(stink)	
stencil	n.(用以刻寫圖案、文字的)範本；v.用範本刻寫	
stentorian	a.(指聲音)極響亮的	
stereotype	n.固定形式，老套	
sterile	a.貧瘠且無植被的；不孕的；無細菌的	
sterilize	v.使不育；殺菌	
stern	n.船尾	
stethoscope	n.聽診器	
stickler	n.堅持細節之人	
stiff	a.僵直的，呆板的，嚴厲的	
stifle	v.感到窒息；抑止	
stigma	n.恥辱的標誌，污點	
stigmatize	v.污蔑，玷污	
stilted	a.(文章，談話)不自然的；誇張的	
stimulant	n.興奮劑，刺激物	
stimulus	n.刺激物，激勵	
sting	v.刺痛；叮螫；n.螫刺	
stinginess	n.小氣	
stingy	a.吝嗇的，小氣的	
stint	v.吝惜，節省	
stipple	v.點畫，點描	
stipulate	v.要求以…為條件；約定	
stipulation	n.規定，約定	
stir	v.刺激	
stitch	n.(縫紉時的)一針，一鉤；v.縫合	
stock	a.普通的，慣用的；n.存貨	
stockade	n.柵欄，圍欄	
stocky	a.矮胖的，粗壯的	
stodgy	a.乏味的	
stoic	n.堅忍克己之人	
stoke	v.給…添加燃料	
stolid	a.無動於衷的	
stomach	v.吃得下；容忍	
stonewall	v.拖延議事，設置障礙	
stout	a.肥胖的；強壯的	
stowaway	n.(藏於輪船、飛機中的)偷乘者	
straightforward	a.正直的；易懂的；直截了當的	
strait	n.海峽；a.狹窄的	
strand	n.繩線的一股；v.擱淺	
stranded	a.擱淺的，進退兩難的	
stratagem	n.謀略，策略	
stratify	v.(使)層化	
stratum	n.地層；社會階層	
stray	v.偏離，迷路；a.迷了路的；零落的	
streak	n.線條，條紋；v.加線條	
stream	n.小溪；水流；v.傾注，湧流	
stretch	v.變長；伸展	
strew	v.撒，散播	
striate	v.在…加上條紋	
striated	a.有條紋的	
stricture	n.嚴厲譴責；束縛	
stride	v.大步行走	
strident	a.尖聲的，刺耳的	
strife	n.紛爭，衝突	
striking	a.引人注目的，明顯的	
stringent	a.(規定)嚴格的，苛刻的；缺錢的	
strip	v.剝去；n.狹長的一片	
strive	v.奮鬥，努力	
stroke	v.撫摸；n.擊，打；一筆	
stroll	v.漫步，閒逛	
strut	v.趾高氣揚地走；n.支柱	
stubborn	a.固執的；難以改變的	
studied	a.慎重的；認真習得的	
stuffy	a.(空氣)不新鮮的，悶氣的	
stultify	v.使變得荒謬可笑；使無用	
stunning	a.極富魅力的	
stunt	v.阻礙(成長)；n.特技，絕技	
stupor	n.昏迷，不醒人事	
sturdy	a.(身體)強健的；結實的	
stutter	n./v.口吃，結巴	
stygian	a.陰暗的，陰森森的	
stylus	n.鐵筆	
stymie	v.妨礙，阻撓	
subdue	v.征服；壓制；減輕	
subdued	a.(光和聲)柔和的，緩和的；(人)溫和的	
subject	n.受支配的人，隸屬	
subjective	a.主觀的，想像的	
subjugate	v.征服，鎮壓	
sublime	a.崇高的	
subliminal	a.潛意識的	
submission	n.恭順	
submit	v.屈服；提交，呈遞	
suborn	v.收買，賄賂	
subpoena	n.(法律)傳票；v.傳訊	
subsequent	a.隨後的，後來的，連續的	
subside	v.(建築物等)下陷	
subsidiary	a.輔助的；次要的	
subsidy	n.補助金	
subsistence	n.生存，生計；存在	
substance	n.大意，根據，實質；物質	
substantial	a.堅固的，結實的；實質的	
substantiate	v.證實，確證	
substantive	a.根本的；獨立存在的	
substitute	n.代替品；v.代替	
subsume	v.包含，包容	
subterfuge	n.詭計，託辭	
subterranean	a.地下的	
subtle	a.微妙的，精巧的	
subtract	v.減去，減掉	
subversive	a.顛覆性的，破壞性的	
subvert	v.顛覆，推翻	
succinct	a.簡明的，簡潔的	
succor	v./n.救助，援助	
succumb	v.屈從；因…死亡	
suffice	v.足夠，(食物)滿足	
sufficient	a.足夠的	
suffocate	v.(使)窒息而死	
suffrage	n.選舉權，投票權	
suffragist	n.參政權擴大論者；婦女政權論者	
suffuse	v.(色彩等)彌漫，染遍	
suggestive	a.暗示的	
suitcase	n.手提箱，箱子	
sulky	a.生氣的	
sullen	a.憂鬱的	
sultry	a.悶熱的；(人)風騷的	
summarily	adv.概括地；倉促地	
summary	n.摘要，概要；a.摘要的，簡略的	
summation	n.總結，概要；總數，合計	
summon	v.召見；召集	
sumptuous	a.豪華的，奢侈的	
sunder	v.分裂，分離	
superb	a.上乘的，出色的	
supercilious	a.目中無人的	
superficial	a.表面的，膚淺的	
superficiality	n.淺薄	
superfluity	n.多餘的量	
superfluous	a.多餘的，累贅的	
superimpose	v.加在上面	
superintend	v.監督	
superiority	n.優越(感)	
supernova	n.超新星	
supersede	v.淘汰，取代	
supervise	v.監督，管理	
supine	a.仰臥的；懶散的	
supplant	v.排擠，取代	
supple	a.伸屈自如的	
supplement	v./n.增補，補充	
suppliant	a.懇求的，哀求的；n.懇求者	
supplicant	n.乞求者，懇求者	
supplicate	v.懇求，乞求	
supremacy	n.至高無上，霸權	
supreme	a.至高的；極度的	
surcharge	v.對…收取額外費用；n.附加費	
surfeit	n.(食物)過量，過度；v.使過量	
surge	v.波濤洶湧，波動	
surgeon	n.外科醫師；軍醫，船上的醫生	
surly	a.脾氣暴躁的；陰沉的	
surmise	n.推測，猜測；v.推測	
surmount	v.克服，戰勝	
surpass	v.超過	
surplus	a.過剩的；盈餘的	
surrealism	n.超現實主義	
surrender	v.投降；放棄；歸還	
surreptitious	a.鬼鬼祟祟的	
surrogate	n.代替品；代理人	
surveyor	n.測量員	
survive	v.倖存	
susceptibility	n.易感性	
susceptible	a.易受影響的，脆弱的	
suspect	v.懷疑；n.嫌疑犯；a.可疑的	
suspend	v.暫緩，中止；吊，懸	
suspense	n.懸念；掛念	
suspicion	n.懷疑，覺察，嫌疑	
suspicious	a.懷疑的	
sustain	v.承受(困難)，支撐(重量)	
sustained	a.持久的，經久不衰的	
sustenance	n.食物，糧食；生計	
suture	n.(傷口的)縫線；v.縫合	
svelte	a.(女人)體態苗條的	
swagger	v.大搖大擺地走	
swallow	v.吞下，咽下；忍受	
swamp	n.沼澤；v.使陷入；淹沒	
sway	v.搖動，搖擺；影響使改變；n.搖動	
swell	v.腫脹，增強	
sweltering	a.酷熱的	
swerve	v.突然改變方向	
swift	a.迅速的；敏捷的	
swill	v.沖洗；痛飲	
swindle	v.詐騙	
swine	n.豬	
swing	v.搖擺；旋轉；n.秋千	
swirl	v.旋轉；n.漩	
sybarite	n.奢侈逸樂的人	
sybaritic	a.放縱的	
sycophant	n.馬屁精	
syllabus	n.教學綱要	
symbiosis	n.共生(關係)	
symmetry	n.對稱；均衡	
symphony	n.交響樂，交響曲	
synchronous	a.同時發生的	
syndrome	n.綜合症狀	
synergic	a.協同作用的	
synopsis	n.摘要，概要	
synoptic	a.摘要的	
synthesis	n.綜合，合成	
syringe	n.注射器	
table	v.擱置，不加考慮	
taboo	a.諱忌的；n.禁忌	
tacit	a.心照不宣的	
taciturn	a.沉默寡言的	
tackiness	n.膠粘性	
tackle	v.處理；n.滑車	
tact	n.機智；圓滑	
tactic	n.(達到目的的)手段；戰術	
tactile	a.有觸覺的	
tadpole	n.蝌蚪	
tag	n.鞋帶；附屬物，標籤	
taking	a.楚楚動人的	
talisman	n.避邪物，護身符	
tally	v.(使)一致，符合	
talon	n.猛禽的銳爪	
tambourine	n.鈴鼓，手鼓	
tame	a.馴服的；沉悶的	
tamp	v.搗實，砸實	
tamper	v.損害，竄改	
tan	v.鞣(革)	
tangential	a.切線的；離題的	
tangible	a.可觸摸的	
tangle	v.纏結；n.紛亂	
tango	n.探戈舞	
tangy	a.強烈的，撲鼻的	
tantalize	v.挑惹，挑逗	
tantamount	a.與…相等的	
tantrum	n.發脾氣，發怒	
taper	n.細蠟燭；v.(長形物體的)逐漸變細	
tapestry	n.掛毯	
tardy	a.緩慢的，遲緩的	
tare	n.莠草，雜草	
tariff	n.關稅	
tarnish	n./v.失去光澤，晦暗	
tarpaulin	n.防水油布	
tart	a.酸的；尖酸的	
tasty	a.味道好的	
tatty	a.簡陋的，不整潔的	
taut	a.繃緊的	
tauten	v.拉緊，繃緊	
tawdry	a.華而不實的，俗麗的	
taxing	a.繁重的	
taxonomist	n.分類學家	
tear	v.撕裂	
tease	v.逗樂，戲弄；強求；n.揶揄，戲弄，取笑	
technocrat	n.技術管理人員	
tedious	a.冗長的，沉悶的	
tedium	n.單調乏味	
teeter	v.搖擺，躊躇	
telling	a.有效的，顯著的	
temerity	n.魯莽，大膽	
temp	v.做臨時工作	
temper	v.錘煉；緩和；n.脾氣	
tempest	n.暴風雨；騷動	
tempestuous	a.狂暴的	
tempo	n.(動作、生活的)步調，速度	
temporal	a.時間的；世俗的	
temporize	v.拖延；見風使舵	
temptation	n.誘惑，誘惑物	
tenable	a.站得住腳的，無懈可擊的	
tenacious	a.堅韌不拔的	
tenacity	n.堅持，固執	
tenant	n.房客	
tend	v.照料，看顧	
tendentious	a.有偏見的	
tender	v.(希望對方接受的意見等)	
tenet	n.信念；信條；教義	
tenor	n.男高音；要點，要旨	
tension	n.緊張，焦慮；張力	
tentative	a.試探性的，嘗試性的	
tenuous	a.細薄的，稀薄的；空洞的	
tenure	n.任期；終身職位	
tepid	a.微溫的	
terminal	a.末端的；n.終點站，終端	
terminate	v.終止，結束	
termination	n.終點	
terminology	n.術語，術語學	
terminus	n.(火車，汽車)終點站	
termite	n.白蟻	
terrace	n.一層梯田；陽臺	
terrain	n.地勢，地形	
terrestrial	a.地球的；陸地的	
terse	a.簡潔的，簡明的	
testament	n.遺囑；證明	
testator	n.立遺囑的人	
testify	v.見證，證實	
testimony	n.證言，證明	
testiness	n.易怒	
testy	a.性急的，暴躁的	
tether	v.用繩或鏈拴住(牲畜)；n.(拴牲畜的)繩或鏈；限度，範圍	
texture	n.質地；結構	
thatch	v.以茅草覆蓋；n.茅草屋頂，茅草	
thaw	v.解凍，溶化	
thematic	a.主題的	
theocracy	n.神權政治	
theoretical	a.不切實際的；理論(上)的	
therapeutic	a.治病的	
thermal	a.熱的，熱量的；溫暖的n.熱氣流	
thesis	n.論題，論文	
thicket	n.樹叢，灌木叢	
thorn	n.刺；荊棘	
thread	n.螺紋	
threadbare	a.磨破的，陳腐的	
threat	n.威脅，恐嚇；凶兆	
thrive	v.茁壯成長	
throne	n.寶座；王位	
throng	n.一大群；v.擁擠	
throwback	n.返祖現象，復舊	
thrust	v.猛力推；刺，戳	
thwart	v.阻撓，使…受挫	
tickler	n.棘手的問題，難題	
ticklish	a.怕癢的；易怒的	
tidy	a.整齊的，整潔的	
tiff	n.吵嘴，嘔氣	
tightfisted	a.吝嗇的	
tilt	v.(使)傾斜；n.傾斜，斜坡	
timber	n.木材；(人)品質	
timbre	n.音色，音質	
timely	a.適時的，及時的	
timid	a.膽怯的	
timidity	n.膽怯	
timorous	a.膽小的，膽怯的	
tinder	n.火絨，火種	
tined	a.尖端的	
tinker	n.補鍋工人；v.拙劣修補	
tint	n.色澤；v.給…淡淡地著色	
tirade	n.長篇的攻擊性講話	
tire	n.輪胎(tyre)；v.疲勞	
tissue	n.細胞組織；薄紙，棉紙	
titanic	a.巨人的，力大無比的	
titular	a.有名無實的，名義上的	
toady	n.諂媚者，馬屁精	
toil	v./n.辛苦，辛勤勞作	
tolerance	n.容許量，公差；容忍，忍受	
toll	n.過路(橋)費；傷亡人數，損失；v.(緩慢而有規律地)敲	
tombstone	n.墓碑，墓石	
tongs	n.夾子，鉗子	
tonic	n.增進健康之物，補品；a.滋補的	
tonsorial	a.理髮師的，理髮的	
topple	v.傾覆，推倒	
torment	n.折磨，痛苦	
tornado	n.颶風，龍捲風	
torpid	a.懶散的，死氣沉沉的	
torpor	n.死氣沉沉	
torque	n.轉矩；項圈	
torrent	n.洪流，急流	
torrential	a.奔流的，洪流的	
tortuous	a.彎彎曲曲的	
toss	v.投，擲；使搖動	
totalitarian	a.極權主義的	
totem	n.圖騰，徽章	
totter	v.搖搖欲墜；步履蹣跚	
touchy	a.敏感的，易發脾氣的	
toupee	n.男用假髮	
tournament	n.比賽；(舊時)騎士比武大會	
tourniquet	n.止血帶	
tout	v.招徠顧客；極力讚揚	
toxic	a.有毒的，中毒的	
toxin	n.毒素，毒質	
toy	v.不認真考慮，玩弄	
traceable	a.可追蹤的	
track	n.足跡，蹤跡；軌道；小道；v.跟蹤	
tract	n.傳單；大片土地	
tractability	n.溫順	
tractable	a.易於駕馭的，溫順的	
tragedy	n.悲劇，慘事，災難	
trait	n.人的顯著特性	
traitor	n.賣國賊，叛徒	
trajectory	n.(拋射物)彈道軌道	
trample	v.踩壞，踐踏	
trance	n.恍惚，昏睡狀態	
tranquility	n.寧靜，安靜	
transaction	n.辦理，交易	
transcend	v.超越，勝過	
transcendent	a.超越的，卓越的，出眾的	
transcendental	a.超越經驗的	
transcribe	v.抄寫，轉錄	
transfer	v.轉移，傳遞；調任，轉讓	
transfigure	v.美化，改觀	
transgress	v.冒犯，違背	
transgression	n.違法，罪過	
transience	n.短暫	
transient	a.短暫的，轉瞬即逝的	
transition	n.過渡時期，轉變	
transitory	a.短暫的	
translucent	a.(半)透明的	
transmit	v.傳送，傳播	
transmute	v.變化，變作	
transparent	a.透明的；直率的	
transplantation	n.移植	
transport	v.運輸；n.狂喜	
transpose	v.變換位置，調換	
trapeze	n.空中秋千	
traverse	v.橫穿過，橫跨	
travesty	v./n.歪曲模仿，曲解	
treacherous	a.背叛的，叛逆的，奸詐的	
treason	n.叛國罪	
treatise	n.論文	
treaty	n.條約；協議	
tremendous	a.驚人的；巨大的	
tremor	n.震動，地震	
trenchant	a.一針見血的	
trend	v./n.趨勢，傾向	
trepidation	n.恐懼，惶恐	
trespass	v.侵犯，闖入私人領地	
tribunal	n.法庭，裁判所	
tribute	n.贊辭；貢物	
trickle	v.一滴滴地流；n.細流	
trifle	n.微不足道，瑣事	
trigger	n.扳機；v.引發，導致	
trilogy	n.三部曲	
trim	v.修剪；a.井井有條的	
trinket	n.小裝飾品；不值錢的珠寶	
trio	n.三重奏，三重唱；三人一組	
tripod	n.畫架，三腳架	
trite	a.陳腐的，陳詞濫調的	
triumph	v./n.凱旋，勝利，歡欣	
trivial	a.瑣細的	
trophy	n.獎品，戰利品	
troupe	n.歌唱團，劇團	
trowel	泥刀，小鏟子	
truancy	n.翹課，曠課	
truce	n.停戰，休戰(協定)	
truculent	a.殘暴的，兇狠的	
trudge	v.跋涉	
trumpet	n.喇叭，小號	
truncate	v.把(某物)截短，去尾	
trunk	n.樹幹；大衣箱	
truss	n.桁架，支架；乾草的一捆	
trustworthy	a.值得信賴的，可靠的	
tuber	n.塊莖，球根	
tumult	n.亂哄哄	
turbulent	a.導致動亂的；騷亂的	
turgid	a.浮腫的，腫脹的；浮誇的	
turmoil	n.混亂，騷亂	
turncoat	n.背叛者，變節者	
turpitude	n.邪惡，卑鄙(行為)	
turquoise	n.綠松石；a.碧綠的	
turret	n.塔樓，角塔	
tusk	n.(象)長牙	
tussle	v./n.扭打，搏鬥；爭辯	
tutor	n.助教；監護人；v.輔導	
tuxedo	n.禮服，無尾禮服	
twig	n.小枝，嫩枝	
twinge	n.(生理，心理上的)劇痛	
typo	n.排印錯誤	
typographical	a.印刷上的	
tyranny	n.暴政，專制統治；暴行	
tyrant	n.暴君	
tyro	n.新手	
ubiquitous	a.無所不在的	
ugly	a.難看的，可怕的	
ulcer	n.潰瘍；腐爛物	
ultimate	a.最後的	
umbrage	n.不快，憤怒	
umpire	n.裁判；v.對…進行仲裁	
unaffected	a.自然的，不矯揉造作的	
unanimous	a.全體意見一致的	
unassuming	a.不擺架子的，不造作的	
unbecoming	a.不合身的；不得體的	
unbend	v.弄直；放鬆	
uncanny	a.神秘的，不可思議的	
uncommitted	a.不受約束的，不承擔責任的	
unconscionable	a.無節制的，過度的	
unconscious	a.不省人事的；未意識到的	
uncouth	a.粗野笨拙的	
unctuous	a.油質的；油腔滑調的	
underbid	v.要價過低	
undercut	v.削價與(競爭者)搶生意	
underdog	n.受欺負者，弱者	
underestimated	a.低估的	
undergird	v.加強	
underhanded	a.不光明的，卑鄙的	
underling	n.下屬，手下	
underlying	a.在下面的，根本的	
undermine	v.破壞，損壞	
underplay	v.淡化…的重要性；表演(角色)不充分	
underrate	v.低估，輕視	
underscore	v.在…之底線；強調	
understate	v.掩飾地說，輕描淡寫地說	
understated	a.不完全陳述的，輕描淡寫的	
understatement	n.輕描淡寫的陳述，不充分的陳述	
understudy	n.預備演員，替角；v.充當…的替角	
underutilized	a.未充分利用的	
underwrite	v.同意負擔…的費用；為…保險	
undeserved	a.不應得的	
undesirable	a.令人不悅的，討厭的	
undirected	a.未受指導的	
unearth	v.挖出；發現	
unearthly	a.奇異的	
unenlightened	a.愚昧無知的；不文明的	
unexceptionable	a.無可非議的	
unfailing	a.無盡的，無窮的	
unfasten	v.解開	
unfeigned	a.真實的；不作假的	
unflappable	a.不驚慌的，鎮定的	
unfold	v.展開，打開；逐漸呈現	
unfounded	a.無事實根據的	
ungainly	a.笨拙的	
ungrudging	a.慷慨的	
unguent	n.藥膏，軟膏	
unicorn	n.(傳說中的)獨角獸	
unidimensional	a.一方面的；一維的	
unification	n.統一，一致	
uniform	n.制服；a.相同的，一致的	
unify	v.統一，使成一體；使相同	
unimpassioned	a.沒有激情的	
unimpeachable	a.無可指摘的，無可置疑的	
uninitiated	a.外行的，缺乏經驗的	
unique	a.獨一無二的，獨特的；無與倫比的	
univocal	a.意思明確的	
unjustified	a.未被證明為正當的，無法解釋的	
unjustly	adv.不義地，不法地	
unkempt	a.(衣服、頭髮)不整潔的	
unleash	v.發洩，釋放	
unmitigated	a.未緩和的，未減輕的，全然的	
unmoved	a.無動於衷的，冷漠的；鎮定的	
unnoticed	a.不引人注意的	
unobtrusive	a.不引人注目的	
unpalatable	a.令人討厭的	
unprecedented	a.前所未有的	
unpremeditated	a.非預謀的	
unprepossessing	a.不吸引人的	
unpretentious	a.不炫耀的	
unprincipled	a.肆無忌憚的	
unproductive	a.徒然的，無成效的	
unprovoked	a.(生氣等)無緣無故的	
unqualified	a.無資格的；無限制的，絕對的	
unravel	v.解開，拆散	
unregenerate	a.不知悔改的	
unregulated	a.未受管理的，未受約束的	
unremitting	a.不間斷的，持續的	
unrepentant	a.不悔悟的，不後悔的	
unrequited	a.無報答的	
unreserved	a.無限制的；未被預定的	
unscathed	a.未受損傷的，未遭傷害的	
unscented	a.無氣味的	
unscrupulous	a.肆無忌憚的	
unscrupulousness	n.狂妄，肆無忌憚	
unseemly	a.不適當的，不宜的	
unsettle	v.使不安寧，攪亂	
unsettling	a.令人不安的，擾亂的，使窘困的	
unsound	a.不結實的，不堅固的；無根據的	
unspoiled	a.未損壞的，未寵壞的	
unspotted	a.清白的，無污點的	
unstinting	a.極為慷慨的，大方的	
unsubstantiated	a.未經證實的，無事實根據的	
untapped	a.未開發的，未利用的	
unthreatening	a.不威脅的	
untimely	a.過早的；不適時的	
untold	a.無數的，數不清的	
untoward	a.不幸的，(壞事)沒料到的	
untutored	a.未經教育的	
unwarranted	a.沒有根據的	
unwieldy	a.笨重的，笨拙的	
unwitting	a.無心的，不經意的	
unwonted	a.不尋常的，不習慣的	
unworldly	a.非世俗的；精神上的	
upbraid	v.斥責，責?	
upgrade	v.提升，給…升級	
upheaval	n.動亂，大變動	
uphold	v.維護，支持	
upright	a.垂直的；正直的	
uproar	n.喧鬧，騷動	
uproarious	a.騷動的，喧囂的；令人捧腹的	
upstage	a.驕傲的，高傲的	
upswing	n.上升，增長	
urgent	a.迫切的，緊急的	
usurp	v.篡奪，霸佔	
usury	n.放高利貸	
utilitarian	a.功利的，實利的	
utilize	v.利用，使用	
utopia	n.理想國，理想的完美境界	
utopian	a.烏托邦式的，夢想的	
utter	a.完全的；v.發出聲音	
vaccinate	v.給…接種疫苗	
vaccine	n.牛痘苗，疫苗	
vacillate	v.遊移不定，躊躇	
vacuous	a.發呆的，愚笨的	
vagary	n.奇想，異想天開	
vagrancy	n.遊蕩，流浪	
vagrant	a.漂泊的；n.流浪漢，無賴	
vague	a.模糊的	
vain	a.自負的；徒勞的	
valediction	n.告別演說	
valedictory	a.告別的，離別的	
valiant	a.勇敢的，英勇的	
validate	v.使…生效	
valorous	a.勇敢的	
valve	n.活門，閥門	
vandalism	n.(對公物等)惡意破壞	
vandalize	v.肆意破壞	
vanilla	n.香草，香子蘭	
vanity	n.虛榮，自負	
vanquish	v.征服	
vantage	n.優勢，有利地位	
vapid	a.索然無味的	
vaporization	n.蒸發	
vaporize	v.(使)蒸發	
vaporous	a.無實質的	
variance	n.矛盾；不同	
variegate	v.使…多樣化	
variegation	n.雜色，班駁	
varnish	n.清漆；v.塗上清漆	
vascular	a.血管的，脈管的	
vault	n.拱頂；地窖	
vaunting	a.吹噓的	
veer	v.轉向，改變(話題等)	
vehicle	n.交通工具；傳播媒介	
veil	n.面紗；遮蔽物，掩蔽物；v.以面紗掩蓋	
velocity	n.速度；迅速	
venal	a.惟利是圖的，貪贓枉法的	
vendetta	n.世仇，宿怨	
vendor	n.小販	
veneer	n.(鑲於劣質東西上的)鑲面板；外表	
venerate	v.崇敬，敬仰	
vengeance	n.報仇，報復	
vengeful	a.報復的，復仇心理的	
venial	a.(錯誤等)輕微的，可原諒的	
venom	n.毒液；惡毒，痛恨	
vent	v.發洩(情緒)；開孔；n.孔，口	
ventilate	v.使…通風，透風	
ventriloquist	n.口技表演者，會口技的人	
veracious	a.誠實的，說真話的	
veracity	n.真實性，誠實	
verbal	a.口頭的；與言辭有關的	
verbiage	n.囉嗦，冗長	
verbose	a.冗長的，囉嗦的	
verdant	a.青蔥的，翠綠的	
verdict	n.判決，決定	
verdigris	n.銅銹，銅綠	
verified	a.檢驗的，核實的	
verify	v.證明，證實	
verisimilar	a.好像真實的；可能的	
veritable	a.確實的，名副其實的	
vernacular	n.本國語，地方語	
versatile	a.多才多藝的；多用途的	
verse	n.詩歌	
vertex	n.(三角形等)頂角；頂點	
vertical	a.垂直的	
vertigo	n.眩暈	
verve	n.(藝術作品的)神韻；(人)生機	
vessel	n.血管；容器；船隻	
vestige	n.痕跡，遺跡	
vestigial	a.退化的	
vestment	n.(作禮拜時教士的)法衣，官服	
veteran	n.老兵，老手；a.經驗豐富的	
veterinary	a.獸醫的	
veto	n.否決，禁止	
vex	v./n.惱火	
vexation	n.困擾，苦惱	
viability	n.生存能力，存活力	
viable	a.可行的；能活下去的	
viaduct	n.高架橋	
vibrancy	n.生機勃勃，活潑	
vibrant	a.振動的；明快的；生機勃勃的	
vibrate	v.顫動，振動	
vicar	n.教區牧師	
vicarious	a.替代的，代理的	
vicinity	n.附近，接近	
vicious	a.殘酷的，危險的	
vicissitudinous	a.有變化的，變遷的	
victimize	v.使受害，迫害	
vie	v.競爭	
vigilant	a.機警的，警惕的	
vigorous	a.精力旺盛的，健壯的	
vile	a.惡劣的，卑鄙的	
vilify	v.辱?，誹謗	
vindicate	v.為…平反；證明…正確	
vindictive	a.報復性的	
vintner	n.酒商	
violate	v.違反，觸犯	
violet	a.紫羅蘭色的；n.紫羅蘭	
viral	a.病毒性的	
virtual	a.實質上的，實際上的	
virtuosity	n.精湛技巧，高超	
virtuoso	n.演藝精湛的人	
virtuous	a.有美德的；自命清高的	
virulent	a.劇毒的；惡毒的	
virus	n.病毒	
viscid	a.粘性的	
viscous	a.粘的	
visionary	a.有遠見的；幻想的；n.空想家	
vista	n.遠景；展望	
vital	a.極其重要的；充滿活力的	
vitalize	v.激發活力	
vitiate	v.削弱，損害	
vitrify	v.使成玻璃	
vitriolic	a.刻薄的，強烈的	
vituperate	v.痛斥，辱?	
vituperative	a.辱?的	
vivacious	a.活潑的，快活的	
vivid	a.清晰的，鮮豔的；大膽的，活潑的，逼真的	
vocalist	n.流行歌手，聲樂家	
vocation	n.擅長；工作，職業	
vogue	n.時髦，時尚；a.流行的	
void	a.空的，缺乏的；n.空隙，空處；空虛感	
volatile	a.反復無常的；揮發性的	
volition	n.決斷力，意志	
volley	n.齊發，群射；v.齊發，群射；(足球、網球)截擊	
voluble	a.健談的；易旋轉的	
voluminous	a.長篇的；多產的	
voluptuous	a.撩人的；沉溺於酒色的	
voracious	a.狼吞虎嚥的，貪婪的	
voracity	n.貪婪	
votary	n.崇拜者，熱心支持者	
vouch	v.擔保，證明	
vulgar	a.無教養的	
vulnerable	a.易受攻擊的	
vulture	n.禿鷲	
vying	a.競爭的	
waddle	v.(鴨子等)搖搖擺擺地走	
waffle	n.蛋奶烘餅；v.胡扯，嘮叨	
waft	v.飄浮，飄蕩	
wag	v.(狗尾巴等)擺動；n.詼諧幽默者	
wage	v.開始，進行(戰爭，運動)	
waggish	a.詼諧的，滑稽的	
walrus	n.海象	
wan	a.虛弱的；病態的	
wanderlust	n.漫遊癖，旅遊熱	
wane	v.減少，衰微	
want	n.缺乏，貧困，需要	
wardrobe	n.衣櫥；全部服裝	
warehouse	n.倉庫，貨棧	
warmonger	n.好戰者，戰爭販子	
warp	v./n.翹起，彎曲	
warrant	n.正當理由；許可證	
warranted	a.保證的；憑正當理由的	
warranty	n.保證；辯解；有正當理由；批准	
wary	a.謹慎的，小心翼翼的	
waste	v.使身體消瘦，損耗	
wastrel	n.揮霍無度的人	
watershed	n.分水嶺，轉捩點	
waver	v.搖擺，猶豫	
wax	n.蠟；v.給…打蠟；盈，增大	
wean	v.(孩子)斷奶；戒掉	
wearisome	a.使人感到疲倦或厭倦的	
weary	a.疲勞的，令人厭倦的；v.厭煩	
weasel	n.黃鼠狼，鼬；v.逃避	
weather	v.經受住，平安度過危難	
weed	n.雜草，野草；v.除草	
weld	v.焊接，熔接；結合	
well-groomed	a.非常整潔的	
welter	n.混亂，雜亂無章	
wheedle	v.(用花言巧語)哄騙	
whet	v.磨快；刺激	
whiff	v./n.輕吹，輕風	
whim	n.多變，怪念頭	
whimsical	a.古怪的，異想天開的	
whimsy	n.古怪，異想天開	
whine	v.哀號，號哭	
whirlpool	n.漩渦	
whisper	v.耳語，低聲說話	
whistle	n.口哨，口哨聲；汽笛聲；v.吹口哨	
whittle	v.削(木頭)；削減	
wholesome	a.促進健康的	
wick	n.蠟燭芯；燈芯	
wicked	a.極壞的；淘氣的	
wield	v.支配，掌權	
willful	a.任性的；故意的	
willow	n.柳樹	
willowy	a.苗條的	
wilt	v.使…凋謝，枯萎	
wily	a.狡猾的	
wince	v.避開，畏縮	
windbag	n.饒舌之人	
winding	a.蜿蜒的，迂回的	
windy	a.有風的；長篇累牘的	
wink	v.使眼色；n.眨眼	
winnow	v.把(穀物)的雜質吹掉，揚去	
winsome	a.媚人的，漂亮的	
wistful	a.惆悵的，渴望的	
wit	n.智力，機智	
withdraw	v.撤退，收回；隱居	
wither	v.枯萎，凋零	
withhold	v.扣留，保留	
withstand	v.頂住；經受住	
witness	n.目擊者；v.目擊	
witticism	n.妙語，俏皮話	
wizened	a.幹皺的，乾巴巴的	
wobble	v.動搖；猶豫	
woe	n.悲痛，苦難	
woo	v.向(女人)求愛；爭取…的支持	
worship	v./n.崇拜，敬仰	
wrangler	n.口角者，爭論者；牧馬者	
wrench	v.扭，擰；n.板鉗，扳手	
wretched	a.可憐的	
wrinkle	n.皺紋；竅門	
wrist	n.腕，腕關節	
writ	n.命令狀，書面命令	
wrought	a.做成的，精煉的	
wry	a.扭曲的；冷嘲性幽默的	
xenophobe	n.懼外者；排外者	
xerophyte	n.旱生植物	
yacht	n.帆船，遊艇	
yarn	n.紗線	
yawn	v.打呵欠	
yearn	v.盼望，渴望	
yeast	n.酵母；興奮	
yielding	a.彎曲自如的；柔順的	
yoke	n.牛軛；v.控制，束縛	
yokel	n.鄉巴佬	
zealotry	n.狂熱行為	
zenith	n.天頂；極點	
zephyr	n.和風；西風	
zest	n.刺激性；熱心，興趣	
zigzag	n./a.之字形(的)；v.彎彎曲曲地行進	
zone	v.分成區	
