word	definition
accelerate	v.加速，不斷增長  
accessible	a.可靠近的
acclaim	v.歡呼，歡迎
accommodate	v.給人提供食宿；與...相符，適應
accommodating	a.樂於助人的
accompany	v.陪伴，伴奏
accord	v.和諧一致
accumulate	v.聚，堆積
abrasion	n.磨損
premium	n.保險金 a.高級的，高價的
abbreviate	v. 縮短，縮寫
abstract	a.抽象的 n.概要
absurd	a.荒謬的
abandon	v. 拋棄
abundance	n.豐富
accustom	v.使習慣 
acquaintance	n.熟悉，認識
acronym	n.首字母縮略詞
acute	 a.敏銳的性急的
adapt	v.適應環境
addictive	a.(吸毒)上癮的
additive	n.添加劑，a.附加的
adept	a.老練的
adjoining/adjacent	a.鄰近的，毗鄰的
adjust	v.調整，校準
adobe	n.土坯，印第安人造房原料
abode	n.住所，住房
adopt	v.收養，採納 
adornment	n. 裝飾
advent	n.來到 
adverse	a.不利的，逆反的  
advocate	v./n.支持，擁護(者)
anesthetic	 a.感覺的
affect	v.影響，假裝 
affected	a.裝模作樣的
affectation	n.假裝
affiliate	"v.變成...的兒子，和...聯合,加盟進去,附加 "
afflict	v.折磨
affluent	a.富有的，豐富的
aggravating	a.一再惡化的 
aggregate	v.總計 
agitation	"n.激動,煽動 "
alchemy	n. 煉金術
alder	n.赤楊樹
sloth	n.樹懶
algae	n.海藻
alien	 n.外國人
allocate	v.分配
alloy	n.合金
ally	n.聯盟，盟軍
alternate	v.交替 
altitude	n. 高度
latitude	n.緯度
aluminium	n. 鋁
ambiance	n.周圍，氛圍
amenable	"a.負責任的,應服從的"
amiable	 a.和藹可親的
amplify	v.放大
annihilate	"v.消滅,殲滅"
annual	 a.一年一度的
anomaly	n.異常的人或物
anonymous	a.匿名的
antibiotics	a.抗生素的
antiquate	"v.使古舊,廢棄"
appeal	"n.上訴,呼籲"
appealing	a.有吸引力的
apprentice	 n.學徒
approach	"v. 接近,n.方法"
aptly	"a.恰當的,得體的"
aquatic	" a.水的,水生的 "
arch	"n.弧形,拱形門,主要的"
archaeology	n.考古學
archipelago	n.群島
architect	n.建築師
arduous	"a.費勁的,勞累的 "
arena	"n.鬥牛場,競技場"
arid	a.乾旱的
armature	n.盔甲
aromatic	a. 芬芳的  n.芳香
array	v. 排列
arthritis	n. 關節炎
arthrosis	n.關節 
artificial	a.人造的
artisan	"n.工匠,藝人"
ascend	"v.攀登,上升"
aspiring	"a.有抱負的,積極的"
assemble	"v.集合,組裝 "
assert	"v.斷言,自我主張"
associate	v.和...相關聯
assorted	a.什錦的 
assume	v.假定
assure	"v.向某人保證,使某人放心"
assurance	"n. 擔保,斷言"
astounding	a.令人震驚的
astute	"a.(人做事)機敏的,機智的"
atomization	n.分離成原子
attach	"v.隸屬,貼"
attain	"v. 獲得,拿到"
attire	 n. 服裝
attribute	v. 歸因於
auditorium	n. 大講堂
auger	"n. 鑽頭,螺絲鑽,尖鑽"
automated/automatic	a.自動的
available	" a.可獲得的,有用的"
aviation	n.航空
avocational	"a.非職業的,副業的 "
aware	v.(主動)意識到
awkward	" a.難使用的,笨拙的"
backdrop	n.(電影)背景幕
ballet	 n.芭蕾舞
balmy	" a.芳香的,止痛的,溫和的 "
barb	 n.(魚)倒刺 
barge	n. 駁船 
bark	v.狗叫 n.樹皮
barn	n.穀倉
bare	a. 不毛之地的
barrier	n.障礙物，柵欄
barter	" n./v.物品交換,以物易物"
basement	n. 地下室 
beak	n.鳥喙
beam	"n. 光線,木結構大樑"
bequest	"n. 遺產,遺贈 被後代請求留下來的東西"
besiege	v. besiege 圍攻
bestow	"v. 授予,給予"
bias	n.偏見
bitterness	"n. 苦澀,辛酸"
bizarre	a.古怪的
blanket	a.毯子
blast	n. 突然性的一陣風，雨，閃光，熱浪等
blazing	a. 熾燒的，閃耀的
bleak	a.荒涼的，寒冷的
blend	 v. 混合
bless	v/n.祝福
block	v.阻擋
blossom	n.鮮花，開花
blues	n.布魯斯音樂，抑鬱
bluff	"n.懸崖v.詐騙,嚇唬別人"
blunt	"a. (人)挨宰的,(刀)鈍的，生硬的"
bolster	n.墊子，靠枕v.支持，支撐
boom	v.迅速發展n.繁榮
boon	 n.恩惠，福利
boost	 v. 促進，增加
bored	a.無聊的
boundary	n. 邊界
bow	n.弓，樂弓
breach	" n.裂開,v.破壞"
breeze	n.微風
brilliant	a.輝煌的，有才氣的 
briny	a.海水的，鹽的
briskly	ad.輕快地，活潑地
brittle	a.易碎的
bronze	n.青銅
bubble	n/v冒泡
buckle	 n.帶扣v.扣住
buggy	n.小馬車
bulk	n.體積，a.大部分
bundle	v.捆成一包n.一捆東西
burdensome	a.繁重的，勞累的
burgeon	v.萌芽，茁壯成長
burrow	n.野兔打的洞
bust	n. 半身胸像
bustle	"v.喧鬧,匆匆忙忙"
cab	n.計程車
cabinet	n.櫥櫃，內閣
cactus(pl.)	仙人掌
calibration	n.標度，校準
campaign	n.運動，戰役，競選運動
cannibalism	n.食人，自相殘殺
canopy	n.天蓬，遮蓬，樹蓋
canyon	n.峽谷，溪穀(寬深)
capability	n.能力
capacity	"n.人的能力,容量,身份"
carapace	n.甲殼
carbohydrate	n.碳水化合物
cardiac	a. 心臟的，強心劑
cargo	n.貨物
carnival	n.狂歡節
carnivore	n.食肉動物
carve	v. 雕刻
cast	v.扔n.劇團，演員表
casting	n.鑄造，鑄件，扮演
category	n.分類，範疇
cater	v.準備食物
cathedral	n.大教堂
cavern	n.岩洞，洞穴
cavity	n.洞，蛀牙洞
cease	v.停止
celestial	a.天上的，天空的 
cell	n.細胞，單人牢房，電池
cello	n.大提琴
census	n.人口普查
ceremony	"n.禮節,儀式"
chafe	 v.擦破，激怒
chamber	n.室，會所，議院，協會
chaos	n.混亂
charcoal	n. 木炭
charter	"n. 圖表,營業執照"
chateau	n.城堡，城堡型的旅館
check	n.支票v.控制
chill	 n.寒冷 
chimpanzee	n.黑猩猩
chisel	n./v.鑿子
cavalry	n.騎兵精神
chop	v.大塊剁 
choppy	a.波濤洶湧 
cord	n.琴弦，心弦
circulator	v.迴圈，流通，圖書發行，借還
circulation desk	n. (圖書館)借還台
circumscribe	vt.在...周圍劃線，限制(孫悟空)
cite	v.引用
civilian	n.平民，百姓
civility	a.彬彬有禮 
claim	v./n.聲稱，主張，認為
clam	n.蛤，貝
clamer	n. 喧鬧
clan	n.宗族
classification	n.分類
clay	n.黏土
cliff	n. 懸崖，絕壁
cling to	v.依靠，堅持
clockwise	a.順時針
clumsy	a.笨拙的
cluster	n.串，群
code of law	n.法典
codify	v.編成法典，編輯成書
coexist	v.共同生存
cohabit	v.同居
cohesion	n.凝聚，凝聚力
coincide	n.巧合
collaborate	v.合作
collective	a.集體的
collide	v.碰撞
colossus	n.巨人
combustible	a.易燃的
comet	n.彗星
commision	 n./v.委託，授權，傭金
committed	a.效忠的
commodity	n.商品 
commonsense	a.具有常識的，通情達理的
communal	a.公共的
commuter	n.經常往返者 
compact	a.壓縮的，簡明的，n.合同
companion	n.夥伴，同伴
comparable	a.可比較的
compatible	a.和諧一致的
compel	v.強迫
compensation	n.補償
competing	a.力量不相上下的
competitive	a.具備競爭能力的
compile	v.編纂
complacence	n.滿足，自滿
complement	v/n補充
complex	a.複雜的，情結
complicated	a. 複雜的
comply with	v.與...一致，照做
component	n.成分
compose of	v.由...組成
composition	n. 作文，作曲，合成物
compound	n. 化合物，混合
compress	v. 壓縮
comprise	v.組成 
conceal	 v.隱藏
concede	v. 讓步
conceive	 v.設想
conception	n.概念
concerted	a.商定的，協調的
concise	a.簡明的
concrete	n.混凝土，a.具體的 
condense	v.濃縮
conder	n.禿鷲 
conductivity	n.導電率
cona	n.圓錐
confederate	n.聯盟 
configurate	v.配置，組成，結構
confirm	v.證實
conflict	n.衝突
confront	v.面對面衝突，對抗
congenial	a.意氣相投的，性格相似的
congestion	n.擁塞
congregate	v.聚集
conifer	n.針葉樹
conjecture	v.推測，猜測
consecutive	a.連續的
consequence	 n.結果；後果
consequently	ad.合乎邏輯的
conservation	n.保護
considerably	ad.十分地，相當地
considerate	a.考慮周到的
consortium	n.國際性協會
constantly	ad.不斷地
constitution	n.章程，憲法
constrain	v.壓制，強迫
constrict	v.約事，收縮
construction	n.建築物
consume	v.消耗，花費
contemporary	a.同時代的人，當代的
contend	"v.聲稱,主張"
content	n.容量，含量
contest	"n.比賽,爭奪(地盤)"
continental	a.大陸性的
continuum	n.連續統，閉聯集
contract	v.收縮
contradict	v. 反駁矛盾
contribution	n.貢獻
controversial	a.有爭論的
convention	n.會議
converge	v.匯合
converse	v.交談
convex	a.凸的
convey	v.傳遞，運輸
convict	a.證明...有罪，宣判有罪
conviction	n.確信
coordinated	a.協調的
copy	v.仿照
coral	n.珊瑚
corona	 n.日冕
corps	 n.團隊，特殊兵種
corral	n.繩子，線，帶
correspondingly	a.相應地
corridor	n.地帶，走廊
corset	n.緊身衣
cosmic	a.宇宙的
costume	n.服飾
council	n.議會，理事會
counterbalance	v.使平衡
counterpart	n.對應的人（或物）
course	v.發展，進程
cowhand	n.牧牛工
crack	n.裂縫
craft	n.手工藝
crash	v.暴跌，墜落
crater	n.隕石坑，火山口
crawl	v.爬
creature	n.生物
credit	n.榮譽
crew	n.人員
crisscross	v.交叉
criteria	n.標準
critical	a.批評的，關鍵的
crooked	a.不老實的，欺詐的
crowbar	n.撬棍
crucial	a.至關重要的
crude	a.粗糙的，原始的
crumple	v.扭彎，弄皺
crunch	n.左右為難的困境，艱難局面
crush	v.壓塌
crust	n.地殼
crustacean	n.甲殼動物
crystal	n.晶體
cubic	a.立方的
culminate	 v.達到頂點
cumbrous	a.累贅的
curator	n.館長，監護人
curriculum	n.課程表
custodian	n.監護人，管理人
cuticle	n.表皮
cylinder	n.圓桶，圓柱體
dash	v.猛衝
daunting	a.使人畏縮的
dawn	n.黎明
dazzling	a.頭暈目眩的
debate	v.辯論，爭論(政治)
debris	n.殘骸，動物枯骨
declaration	n.申報，宣言
decline	 n./v.衰退
decorate	 v.裝飾，裝修.
defecate	"v.澄清,通大便"
deference	 n.尊重，順從
deficiency	n.缺乏，不足(帳目)
deform	v.變成畸形
deft	a.敏捷的，熟練的，靈巧的
degradation	n.降級，退化
dehydrate	v.脫水
deliberate	a.故意的，深思熟慮的
delicate	a.精美的
delta	n.三角洲
demobilize	v.復員
demolish	"v.毀壞,推翻"
dense	a.濃密的，密集的density密度
depict	v.描述
deplete	v.耗盡
deposit	v./n.儲存，沉澱，押金，存款，礦藏
depredation	n.掠奪depredate
depreciation	"n.貶值,降價"
depression	"n.精神壓抑,蕭條"
derive	"v.派生,起源"
desalination	n.脫鹽，淡化鹽水
descend	v.下降
designate	 v.指定
desirable	a.很好的，可行的，合意的
desirous	a.渴望的
desperate	a.絕望的
despoil	v.奪取，掠奪
destruction	n.毀壞
detect	"v.察覺,偵查"
deter	v. 阻止
deteriorate	v.使惡化
determinant	a. 決定性的，決定因素
devastate	v.(大面積)毀壞
device	 n. 裝置，設備
devoid	a.缺乏的，全無的
devour	v.吞食 
devout	a.虔誠的
diagonal	n./a.對角線
diameter	n.直徑
dictate	v./n. 口述，命令，聽寫
diction	n.措詞，用語
differentiate	v.區別，分化
diffuse	v.散播，擴散
digest	v.消化，摘要
digress	v.離題 
dilute	v.沖淡，稀釋 
diminish	v.縮小，變小，減少
dinosaur	n.恐龍
discard	v.拋棄
discern	v.目睹，辨別
discharge	v.釋放，放電，履行(義務)，解雇
discipline	 n.紀律
discourage	v.使氣餒，阻礙
discourse	n.演講，文章
discreet	a.謹慎的
disintegrate	v.使分解，瓦解，碎裂
dispense	v.分發，分配
disperse	v.分散，傳播
disposal	n.處理 
disposed	"v.有...傾向的,願意的"
disproportionate	 a.不成比例的，比例失調的
dispute	n./v.糾紛，爭論
disputant	n.爭論者
disrepute	n.壞名聲，不光彩
disseminate	v.傳播
dissipated	a.分散的，浪蕩的，沉迷酒色的
dissolve	v. 溶解，解散
distent	a.膨脹的，擴張的
distinct	a.不同的，清楚的
distinctive	a.有特色的，與眾不同的
distort	v.扭曲，歪曲
distract	v.轉移
distribute	" v.分發,分配,(貨物)"
diver	n.潛水夫
diverge	v.分歧，分叉
diverse	a.不同的，變化多的
diversify	v.使多樣化
diversion	n.轉換，轉移，解悶，娛樂
documentation	n.檔，記錄
dodge	v.躲開
dogma	n.教條
dolphin	n.海豚
domain	n.領域，範圍
domestic	"a.國內的,家庭的,馴服的"
dominant	a.有統治權的，佔優勢的
domination	n. 統治管轄
dormant	a.冬眠的
drain	v.排水 
dramatic	a.戲劇性的，生動的
drawback	n.缺點 退稅
drill	v.鑽n.鑽子
drought	n.乾旱
ductile	a.易延展的，易交道的，柔軟的
dump	v.傾倒(垃圾)
durable	a.持久的，耐用的
dwarf	n.矮子
eccentric	a.古怪的，反常的，n.怪人
eclipse	n.日食，月食
ecological	a.生態學的
economize	v.節約，省錢 
edentate	a.無齒的，貧齒類動物
edible	a.可食用的
edifice	n.大廈(來自聖經)
eject	v.噴射，逐出
elaborate	v.精工細做，詳細說明
elaborately	ad.苦心經營地，精巧地
electron	n.電子
elegance	a.高雅
elevation	n.海拔
elicit	v.引起，得出
eligible	a.合格的，有資格的
eliminate	v.消除
elite	n.精英
elixir	n.萬能藥，煉金藥
elliptical	a.橢圓的
elusive	"a.難懂的,難捉摸的"
embed	v.插入，嵌入
embellish	v.修飾
emboss	vt.凸出來
embryology	n.胚胎學
emerge	v.浮現
emigrate	v.移出，移居
emission	n. 排放
employ	v.雇傭，使用，利用
enact	v.頒佈
encounter	 v. 遭遇
engrave	v.雕刻
enormous	a.巨大的
entangle	v.糾纏不清
enterprise	n.事業，企業
entity	n.存在物，實體
entrepreneur	n.企業家
enzyme	n.?
epidermis	n.表皮，上皮 
epoch	n.新紀元，時代
equilibrium	n.平衡
equivalence	n.等價
erect	 v./a.豎立 
erosion	n.腐蝕，侵蝕
eruption	n.爆發，火山灰，出疹
eternal	a.永恆的
ethically	a.道德上的，倫理上的
ethnic	a.人種的，種族的
evaporate	v.蒸發
eventful	a.變故多的，多事之秋的
evergreen	a.常青的
evident	a.明顯的，顯然的
eviscerate	v.取出內臟
evoke	v.喚起，博得
evolution	n.進化
exalt	v.讚揚，晉升
excavate	v.挖掘，挖空
exceed	v.超越
excel	v.勝過
exception	n.例外，反對
excess	 n.過度，超額
exclude	v.排除
exclusive	"a.排外的,唯一的"
execution	n.執行，死刑
executive	n. 經理
exempt	v.免除，被免除的
exert	v.努力，用力氣，施加力氣
exhale	v.呼氣
exhibition	n.展覽，表現，出風頭
exobitance	n.過度，不當
expand	v. 膨脹，發展
expedition	n. 遠征，探險隊
expenditure	n.支出，花費
expertise	n. 專門技術
explicit	a.明確的
exploit	v. 開發，利用
exponential	a. 指數的
express	n. 特快專遞
expressive	a. 有表現力的，表達...的
extend	v. 向外延伸
extensive	a.廣泛的
exterior	n. 外部的，外部
external	a.外部的
extinct	a. extinct滅絕的 
extract	v.提取，拔出(牙)，精華
fabric	n.紡織品
facility	n. 設施，設備
facilitation	n.方便，簡化
faction	n. 派別，小集團，內訌
factor	n. 因素
faculty	n. 本領，能力，全體教員，系
fade	v.褪色
famine	n.饑荒
fanatic	n. 狂熱者，盲信者
fascinate	v. 著迷
fascinating	a.令人著迷的，醉人的，好玩的
fashionable	a.時髦的，流行的
fatal	a.致命的
fatigue	n./a.疲勞
faucet	n.水龍頭
fauna	n.動物群，動物志
feasible	a.可行的
feat	n. 功勞，攻擊
fencing	n. 籬笆，劍術
fend	v. 供養
fertile	a. 土地肥沃的，人有生育能力的
fertilize	v. 施肥，受精
festival	n. 節日
feverish	a.興奮的，狂熱的
fibre	n. 纖維
fiction	n. 故事，虛構
fidelity	n. 保真度
fieldresearch	n. 野外實地考察
file	v.把...歸檔，用銼刀銼
fir	n. 杉木
flare	n. 火花
flake	n. 薄片
flea	n. 跳蚤
fleeting	a. 短暫的，轉瞬即逝的
flexible	a. 靈活的，柔韌的
float	v. 漂浮
flock	n. 一群
fluctuation	n. 波動
folklore	n. 民俗學
folly	a. 愚蠢
forage	n. 草料，放牧動物
forbidden	a. 禁止的
forbidding	a.可怕的，令人難親近的
foremost	a. 最前列的
foresee	v. 預見
foreshadow	v. 預示不祥的東西來到
forge	v. 鑄造，穩步前進，偽造
formalize	v. 使形式化 
formation	n. 形成，編隊
formidable	a. 可怕的，強大的
formulate	v. 用公式表示，明確表達陳述
fort	n. 堡壘
fortify	v. 加強，鞏固
fortuitous	a.偶然的，幸運的
fossilize	v. 使成化石，使陳腐
foster	v.養育，培養
fracture	n. 骨折
fragile	a.易碎的
fragment	n. 碎片
fray	 v.磨損 n.衝突
freight	v.運貨 n.貨物，貨運
frenetic	a.發狂的
frenzy	n.狂暴
frigid	a.寒冷的
fringe	n.邊緣，劉海
frustrate	v.挫敗，使灰心
frustration	n.挫敗的狀態
fume	"v, (冒)煙，用煙熏"
function	n. 作用，功能
fungi	n. 真菌類(口)腳氣
fungus	n. 菌類，蘑菇
furnish	v.提供
fuse	n. 保險絲
galaxy	n.星系
gallery	n. 美術館，畫廊
galvanize	v. 電鍍，鼓勵
gap	n.代溝，裂口
gassy	a.氣體的，吹牛的
generation	v.產生
generous	a. 慷慨的，大方的
genetic	a. 遺傳的
genial	a. 親切的
genre	n. 文學流派(法文)
genuine	a. 真正的，真實的
giant	n.巨人，a. 巨大的
girder	n. 鋼結構大樑
glacier	n. 冰川
glamorous	a. 富有魅力的
gland	n. 腺體
glassware	n. 玻璃器皿
glimpse	v瞥見 
global	a. 全體的
gorgeous	a.華麗的，好的
gormand	n.美食家
granite	n.花崗岩
graphic	a.圖畫的，圖表的
grasshopper	n. 蝗蟲
grave	n. 墓穴，嚴重的，v. 雕刻
gravity	n.地心引力
graze	 v.放牧，吃草
grumble	v.抱怨
gulf	n. 海灣
gush	v.湧出
gymnastics	n.體操
gyration	v.旋轉
habitat	n. 動物棲息地
hail	 v.歡呼，冰雹
hallmark	n. 特點
halt	n. 停止
hamper	 v.妨礙，牽制
handcraft	n.手工藝品
harden	v. 使變硬
hardware	n.五金用品
harness	n. 馬具v.利用 
haste	n.匆忙
hatch	v. 孵卵，艙蓋
haul	v. 用力拖
haven	n. 港口，避難所
hazardous	a. 危險的
heed	 v./n.注意到
heel	n. 腳後跟
helium	n. 氦
hem	n. 邊緣 
hemisphere	n.半球
herald	n.先驅，使者
herculean	a.力大無比的
herd	n. 獸群
heritage	n. 遺產
heterogeneous	a.異類的
hibernation	n. 冬眠dormancy
hierarchy	hierarchy(hier神achy統治)等級制度，層次
highlight	n. 加亮區，突出
hinge	n. 鉸鏈
hinterland	n. 內地.落後地帶
hollow	n. 洞，空的
horizon	n. 地平線
horizontal	a. 地平線的，水準的
hostile	a. 敵意的
house	 v.給...房子住
huddle	a. 擁擠，擠作一團，雜亂的一堆
hurl	v. 用力投擲
hydrogen	n. 氫
hypersensitive	a. 過分敏感的
hypothesis	n. 假說
iceberg	n. 冰山
icicle	n. 冰柱，垂冰
icon	n.圖示，偶像
identical	a. 同一的，一模一樣的
identifiable	a. 可確認的
ideology	n. 意識形態
idiom	n. 習語
ignite	v.點燃
illuminate	v. 闡明
illusion	n. 幻覺
illustrate	v. 闡明，舉例說明，圖解
imaginary	"a. 想像的,非真實的"
imbibe	v.吸收
imitation	v. 模仿
immense	a. 極廣大的，無邊的
immobilize	v. 固定不動
immune	a. 免疫的
impact	v. 碰撞，衝擊
impair	v. 損壞，削弱
impart	 vt.給予，傳授
impediment	n.妨礙，(言語)障礙
imperative	a.命令的，強制的
impermeable	a.不能滲透的
impersonal	"a.非個人的,公正"
impersonate	v.扮演某種角色
impetuous	a.衝動的，激烈的
implement	 n.工具v.實施
implication	n.含意
implicit	a. 含蓄的
import	v./n.i進口
impose	"v.強加,徵稅"
imposing	"a. 使人難忘的, 壯麗的"
impressive	"a. 給人深刻印象的,感人的"
imprint	 v.留下烙印
imprisonment	 n.監禁，關押
improvise	v.臨時準備，即席演出 
inaccessible	" a.達不到的, 難以接近"
inactivate	"v.使不活潑, 阻止活動 "
inadequate	"a.不足夠的, 不適當的"
inappropriate	" a.不適當的, 不相稱的"
incapacitate	"vt.使無能力, 使不能勝任"
incessant	" a.不斷的, 不停的"
incident	n.偶發事件
inclination	"n.傾斜,傾向"
incongruence	n.不全等，不一致
incongruent	a.不一致的
incorporate	v. 合併，組成公司
incredible	a.難以置信的
indent	v.使成鋸齒狀，訂貨
indented	a.犬牙交錯的，高低不平的
indicate	v.指出，預示
indispensable	n./a.不可缺少的(物)
individualism	"n.個人主義, 利己主義"
inducible	"a.可誘導的, 可導致的"
induction	n.感應，歸納
industrialization	"n.工業化, 產業化"
inevitable	"a.不可避免的, 必然的"
inextricable	"a.無法解脫的, 逃脫不掉的 "
infection	n.傳染；感染力
inferiority	n.自卑；次等
infest	v.大批滋生
inflation	n.通貨膨脹
inflict	v.招來麻煩
influx	n.流入
ingenious	a.天才的，有獨創性的
ingenuous	a.真誠的，直率的
ingredient	 n.(食品)成分
inhabit	v.居住
inherit	v.繼承
inhibit	v.禁止，約束
innumerable	a.數不清的
insanity	n.精神錯亂，瘋狂(反)sanity心智健全
insight	n. 洞察力
insistence	n.堅持，堅決主張 
inspection	n.檢查，視察
inspiration	n.靈感
inspire	v.鼓勵，激勵
instantaneous	a. 瞬間的，即刻的
instinct	n. 本能
institute	n. 學院，協會
institution	n. 公共機構，制度
institutionalize	v. 使制度化
instructive	a. 有益的，有指導性的
instructor	n. 講師
instrumentalist	n.樂器演奏家
insulin	n. 胰島素
insulting	a. 侮辱性的，欺負人的
insurmountable	a. 不可超越的
intact	a.完整無缺的，尚未被人碰過的 
integral	a. 完整的，不可分割的(數)積分
integrate	v.使成整體 
intelligible	a.可理解的
intense	a. 強烈的
intensive	"a. 強烈的,精深的"
intent	n. 意圖，目的
interact	v.相互作用
interconnect	v.使互相連接
interdependent	a.相互依賴的
interference	n. 衝突，干涉
interior	a.內部的，室內的
interlock	v.互鎖
internal	a. 內在的，國內的
interpersonal	a.人與人之間的
interpretation	n. 解釋，闡明，口譯
interrupt	v.打斷(談話或行動)
interstellar	a.星際間的
interval	n. 間隔，幕間休息
intervention	n. 干涉
intimacy	n.親密關係
intoxication	n.陶醉
intriguing	a.複雜的
intrinsic	a.引起興趣的
intrude	a.內在的，固有的
invade	 v.闖入
invertebrate	 a./n.無脊椎的(動物)，無骨氣的(人)  
irresistible	a.不可抵抗的
irreverence	adj.不尊敬行為
irreversible	a. 不可逆轉的
irrevocable	a.不能取消的
irrigate	v.灌溉
isolated	a.隔離的，孤立的
jealousy	n.妒忌
jellyfish	jellyfish海蟄
jolt	v.搖晃
journalism	n.新聞業
junction	n.(道路)交叉處，接合
jury	n. 陪審團
judgement	n.法官的裁決
juxtaposition	n.並排
keen	a.熱切的，渴望的，敏銳的
kennel	n.狗窩，狗屋
kernel	n.果仁，核心
kerosene	n.煤油
kinetic	a.運動的
laborious	a.艱苦的
labyrinth	n.迷宮
lament	v./a.悲傷，哀悼
landmass	n.大陸
landscape	n. 陸地風光
landslide	n. 山崩，滑坡，崩塌的泥石
larva	n. 幼蟲
laser	n. 鐳射
lava	n.熔岩，火山岩
lavatory	n.廁所
lave	v.沐浴
layer	n. 地層
layman	n.外行
lease	 n.租約
ledge	 n.架狀突出物，暗礁，礦層，壁架
legacy	n.遺產
legume	n. 豆類，豆莢
lengthen	v.加長
lettuce	n.萵苣，生菜
limestone	n.石灰石
linger	v.逗留，拖延
litter	v. 亂丟廢物，使混亂
livelihood	n. 生計
livingquarters	n. 公寓式住房
locomote	v. 移動，行動
locomotive	n. 火車頭
log	n. 原木，航海日誌v.記錄
loom	n. 織布機v.隱現，迫近
lore	n. 民間的全部傳說和知識
lumber	n.原木，笨重地行動
luminosity	n.發光度 
luminary	n. 發光體，知識淵博的人，名人
lure	v.引誘，誘惑
lyric	n .抒情詩
magnesium	n. 鎂
magnet	n.磁體，磁鐵
magnify	 v.放大，誇張
magnitude	n.大小，數量，巨大，恒星亮度單位
majestic	a. 壯觀的
majority	n. 大多數人，多數民族
makeup	n.化妝品，補充，結構，外在包裝
malleability	 n.有延展性，柔韌性
malleable	a.有延展性的，可鍛造的 
mammal	n. 哺乳動物
mammoth	n.猛?象，a.巨大的
manoeuvre	v.操縱，演習，調動 n.策略，調動
mania	n. 狂熱病，癲狂
manifest	a.明顯的 v.表明，出現
manifestation	n.顯示，證明，示威運動
manipulate	v.熟練地操作(機器)，操縱
mansion	n. 大廈，官邸 
manual	a.手工的，n.手冊
margin	n.邊緣，利潤
marine	n.海洋的，艦隊
maritime	a.海上的，海員的
markedly	ad.顯著地，明顯地
marrow	n.骨髓，精華，元氣
mask	n.面具，v.掩蓋
masonry	n.石工術
massive	a. 巨大的，廣泛的
masterpiece	n.傑作
mate	n. 配偶，同伴 v.交配
meagre	a.瘦的，貧弱的
measures	n.措施，方法
mechanic	a.機械的
mechanism	n.機械原理，機構，機制
media	n.媒體
melodrama	n.情節劇
memorial	n.紀念品，紀念館
mercantile	 a.商人的，商業的
merchandise	n.商品，貨物
metabolism	n.新陳代謝
meteorite/meteor	n.隕石，流星
meteorology	n.氣象學
meticulous	a.謹小慎微的
metropolitan	a.首都的，大城市
micro-organism	n.微生物
microscope	n.顯微鏡
migrate	v.遷移
milestone	n.里程碑
millenarian	a.千年的
mime	n. 默劇
mimetic	a.模仿的，(生)擬態的
mingle	v.混合
miniature	n.縮小的模型，縮影
minimize	v.最小化
minuscule	 n.草寫小字，極其微小的
minute	n.分鐘，微小的
miraculous	a.奇跡的，不可思議的
mobility	n.能動性，靈活性 
mock	v.模仿性地嘲笑別人
moderate	a.適度的，中等的
modify	v.更改，修改
moisture	n.潮濕，濕氣
molecule	n. 分子
molten	v.熔化，a.熔鑄的
monochromatic	a.單色的
monopolise	v.壟斷
monument	n.紀念碑
morale	n.士氣，民心
morphology	n.形態學
mostdistinctive	a.最最傑出的，典型的
motif	n.作品的主題
motivation	n.觸動能力
mortar	n.灰泥，石臼
multifacetive	a.多方面的
multiple	n.多樣的
multistory	n.多層建築
multitude	n.多數，群眾
mundane	a. 世俗的
municipal	a.市政的
muscular	a.肌肉的，強健的
myriad	a.無數的
mysterious	a.神秘的
narcotic	a. 麻醉藥
narrater	a. 敘述者，講故事者
neat	a. 乾淨的
needy	a. 貧困的，缺乏的
neoclassical	a. 新古典主義的
neon	n.霓虹燈
nerve cord	n.骨髓
neural	a.神經系統的
neutron	n.中子
neuter	a.中性的，無性動物
niche	n.凹進去的牆壁，用來放佛龕等
nickle	n.五分鎳幣
nonconformist	n.非國教徒
nontraditional	a.非傳統的，不符合傳統的
nostalgia	 n.思鄉病
nostrum	n.秘方，民間秘方藥
notch	v.形刻痕，n.峽谷
note	n. 音符 
notorious	a.臭名昭著的
noxious	 a.有害的，有毒的
nuclei	n.核心
object to	v.反對
obscure	a.模糊的，使不明顯
obsess	v.迷住，使困擾
obstacle	n.障礙，妨礙物
occurrence	 n.發生，出現，事件
offspring	n.兒女，後代
olfactory	a.嗅覺的，能聞到的
onslaught	n.衝擊，猛攻
opaque	a.不透明的
optic	a.光學的
optimal/optimum	"a.最佳的,最理想的"
orchid	n.蘭花
ore	n.礦石
organically	ad.器官上地，有組織地，有系統地
organism	n.生物體，有機體
orientation	n.方向，定位，定向，熟悉
originality	 n.創意，新奇
ornamental	a.裝飾性的，觀賞植物
ornamentation	n.裝飾，裝飾品
ounce	n.盎司(秤黃金的單位)
outbreak	n.(戰爭的)爆發，(疾病的)發作
outlet	n.出口，出路，感情的發洩口
output	n. 產量，輸出
oval	a. 橢圓形的
overlap	 v.與...交迭
overload	v./n.超載
oversee	v. 俯瞰，監督
overtax	 v.課稅過重，使負擔過度
overwhelm	v.淹沒，壓倒，勝過一切
overwhelming	a. 壓倒性的，無法抵抗的
ox	n. 公牛
pack	v.打包n.(狼)群
packed	a.擠得滿滿的
painstaking	 n.苦幹 a.辛苦的，需要花力氣的
paleontologist	 n.古生物學家
pane	n.長方塊，窗格玻璃
panel	n.儀錶板，座談小組
pants	n.褲子v.氣喘
paralysis	 n.癱瘓
paralyze	v.使麻痹
paramount	a.極為重要的
paraphrase	 v./n.用簡單解釋，意譯
parasite	n. 食客，寄生蟲
particle	 n.粒子
pasture	n.牧場，v.放牧
patent	n.專利權
pathogeny	n.病原體，生病
patrol	 v./n.巡邏
patron	n.贊助人，資助人
patronage	n.光顧，贊助 v.光顧，資助
pebble	n.小鵝卵石
peculiarity	n.特性，怪癖，土特產
pedant	n. 下垂物，垂飾
penchant	n.強烈的傾向，趣味
penetrate	v.刺穿，滲透，洞察
penetrating	"a,明察秋毫的，(說話)一針見血的"
peninsula	n. 半島
perceive	 v.察覺到，感覺到
perch	n.棲木v.使棲息
percolate	n.濾液 v.過濾percolator篩檢程式，漏勺
percussion	n. 震盪，影響，打擊樂器
percuss	v.輕敲percussive a.敲擊的
peripheral	a.周圍的，不重要的；n. 週邊設備
periphery	n. 圓的周圍，邊緣地帶
perishable	a.容易腐爛的
permeate	 v.滲透
perpetuate	v.使永存
perplexing	a.令人困惑的
persist	v.堅持
perspective	n.視角，透視圖，觀點
pertinent	a.相關的，中肯的
pest	n. 害蟲
petal	n.花瓣
pigment	n.色素，顏料
pillow	n.枕頭
pine	n.松樹
pit	n.坑，陷阱
pivotal	a.關鍵的，樞軸的
plank	n.厚木板
plaster	n.石膏，灰泥
plate	n.盤子，版圖，平面板
platitude	n. 平凡，陳詞濫調
pliable	a.柔軟的，易曲折的
plight	n.困境
plumbing	n. 管道系統，鉛工業製造
plumber	n. 管道工
poisonous	a.有毒的
polarize	v.極化，使兩極分化
pollen	n. 花粉
pollutant	n. 污染物
popular	n. 流行歌曲
portable	a. 輕便的，手提的
portent	n. 預兆
portion	n. 一部分
positive	a.肯定的
possess	v. 擁有，支配
postal	n. 郵政服務
postdate	n. 填遲...的日期
posthumous	a. 死後的，遺腹的
potential	a.潛在的，潛能
pottery	n. 陶器
poverty	n. 貧困
prairie	n. 大草原
precarious	a. 不穩定的，要小心的
precede	v. 優先於
precipitate	n. 沉澱物v.促成，陡然下降
precipitation	n. 降雨量
precursor	n. 先驅
predator	n. 食肉動物
predatory	a.掠奪的，食肉的
predecessor	n. 前輩，前任
predominance	n.優勢
predominate	v.掌握，控制
preeminent	a.卓越的
prefabricate	v.預製
prehistory	a. 史前時期的
preponderance	 n.優勢，佔優勢(重量上)
ponderous	a. 笨重的
prerequisite	n.先決條件
presence	 n.出席，到場
presentation	 n.介紹，表達
preservation	n.保存
prestige	n. 名聲，聲望
pretension	n.藉口，自負
prevail	v. 佔優勢的，主要的
prey	prey被捕食動物v.捕食predator捕食動物
primal	a. 第一的，最初的
primarily	a.主要的
primate	n. 靈長類動物
prime	a.主要的
primitive	a. 原始的
priority	 n.優先權
privilege	n.特權
probe	v./n.探索，調查
proceed	v.向前進，繼續下去，發生，加工
process	n.過程，方法 v.加工
proceeds	n.收益
proclaim	v.宣告，聲稱
proclivity	n.傾向，癖好
prod/spur	v.刺激某人去做某事
prodigious	a.巨大的，揮霍的
prodigy	 n.驚人的事物，天才
produce	v.生產，n.農副產品
proficiency	n.熟練，精通
profile	n. 傳略；人物簡介;大眾的注意
prohibitive	a. 昂貴得讓人怯步的
proliferation	n.增殖，大量繁殖
prolific	a. 多產的
prominent	a.顯著的，突出的
promising	a.有希望的，有前途的
promote	v.推動，提升，對商品宣傳
pronounced	a. 顯著的，明確的
proper	a. 恰當的，得體的
property	n.財產
proponent	n.建議者，支持者
proportion	n. 比例
proprietorship	n. 所有權
propulsion	n.推進，推進力
prospect	n. 景色，前景，前途
prosper	v.成功，昌盛，蓬勃發展
prosperity	 n.繁榮，發達
protectionist	n.貿易保護主義者
protein	n. 蛋白質
prototype	n. 原型
protrude	v.突出
provincialism	n. 地方風尚，心胸狹窄
provocative	a. 煽動的，刺激物
prudent	a.謹慎的
publicize	 v.宣揚
punch	v.打孔，打別人一拳，混合飲料
puncture	n. 小孔，刺破
purification	n.淨化
pyramid	n. 金字塔
quaint	a. 古怪有趣的，精巧的
qualification	n.資格，限定
quarry	n.採石場，獵物，(知識等)來源
quench	v.熄滅，平息，鎮壓
quest	v.尋求
quiescent	a.安靜的，靜止的
quilt	a.被子
radar	n. 雷達
radiation	n. 放射，發光，放熱
radical	a.激進的，根本的，n. 激進分子
radius	n.半徑，範圍
raft	n.木筏
ragtime	n.拉格泰姆黑人音樂，a.滑稽的
rally	"v.重整旗鼓，恢復精力，n.汽車拉力賽,集會"
rampant	a.猖獗的，蔓生的，狂暴的
rancher	n.牧場主，牧工
range	n.範圍，山脈，射程
rarefy	 v.使稀少，稀薄
ration	v./n.定量分配，配給
rattlesnake	n. 響尾蛇
raven	n. 烏鴉 v.掠奪
readjust	v. 重新調整
realm	n. 領土，領域
rear	n./a.後面(的)v.養育，培養
rebellion	n.謀反，反抗
receptacle	n. 容器，花托，插座
receptor	n.神經接收細胞，接收器
recipe	n.食譜，處方
recipient	n.接受人，容納者，容器，容易接受的
recognise	 v.承認，識別，認可
reconstruct	v.重建，改造，推想
recreation	n.娛樂，消遣
rectangle	 n.長方矩形
recycle	v.使再迴圈，回收
redirect	v.(信件)重寄，使改道，使改變方向
reed	n.蘆葦
refine	v.提煉
refined	a.精製的，優雅的
reflection	n.反射，倒影，反思
refraction	n.折射
refreshing	a.提神的，涼爽的
refreshment	n. 點心，飲料，精力恢復
refrigerate	v.使冷卻，冷藏
regenerate	v. 使新生，改革，革新
regime	n.整體，政權
regimentation	n.管轄，團隊精神
regulate	v.正規管制，控制，調節
regulatory	a.按照規矩來的，調整的，規範的
rehabilitate	v.使康復，使複職，使恢復名譽
reign	v./n.統治，統治時期
reinterpret	v.重新解釋
reject	v.拒絕，不及格者
release	v./n.釋放，版本，發表
remainder	n.殘餘，剩餘物
render	v. 遞交，致使
renounce	v. 放棄(信仰，法律)，斷絕關係
rent	n.租金，出租；分裂的，有矛盾的
reorient	v.重新確定研究方向，再教育
replace	v. 代替，取代
replenish	v.重新補充
representation	n.代表，體現
reproduce	v.繁殖，增加，複製，使重現
reptile	n. 爬行動物
repute	n.名聲(中性詞)
resemble	v.象，類似
reservior	n.水庫，貯存
residue	n.殘渣
respective	a. 分別的，各自的
restoration	n.恢復，複職，重建，翻新
restrict	v.限制，禁止
retail	n.零售
retain	v.保持，保留
retool	v.將機械重新整備，重組
retreat	v.撤退，後退
retrieve	v.重新得到，n.找回
reveal	v.展現，暴露
reverend	a. 可敬的，尊敬的
reverse	v.倒轉，n.反面
revise	v.修改
revitalization	n.新生，復興(使重新充滿活力)
revival	n.蘇醒，復活
rhetoric	n. 修辭學
rhythm	n.節奏，韻律
ridge	n. 山脊
rift	n. 裂口，裂縫，長峽谷，不和
rigidity	 n.僵化，硬度
riot	n. 暴動
ripen	v. 成熟
rite/ritual	n. (宗教，傳統)固定的儀式
rival	n.競爭對手 v.和...競爭，相匹敵
roam	v.漫遊
robust	a. 精力充沛的
rod	a. 竹竿，魚杆
roost	n./v.棲木，棲息
roust	v.驚起，喚醒，驅逐
rotate	v.使旋轉
rubble	n. 碎石，瓦礫
rudimentary	a.原始的，根本的，未發展的
rupture	 v./n.斷裂，斷絕(關係等)
rural	a. 鄉村的
rustproof	a. 不鏽的，v.使不生銹
sack	n. 麻袋 v.解雇
sacred	a. 神聖的
saddle	 n.馬鞍，v.承受
sample	n. 樣本
sanctimonious	a. 假裝神聖的
sanction	n./v.批准
sanctuary	n. 避難所，鳥獸保護區
sanitation	n.衛生，衛生設施
satire	n.諷刺，諷刺文學
saturate	 v.使飽和，浸透
scale	n.魚鱗，比例v.攀登，測量
scarce	a. 稀少的，不足的
scare	v./a.驚嚇
scatter	v.分散
scavenger	n.清道夫，食腐動物
scenery	n.風景的總稱
scenic	a. 風光的，佈景的
scent	n. 味，香味，嗅覺
scheme	n. 方案，計畫，陰謀
score	n.分數，帳目，起跑線
scramble	n./v.攀爬
scratch	v.亂塗，抓，搔n.抓痕
screen	n.銀幕v.掩蓋
screw	n. 螺絲釘
scruple	n./v.猶豫，顧慮
sculpture	 v./n.雕刻
sea cucumber	n.海黃瓜，海參
seabed	 n.海底，海床
seaport	n.海港，港口城市
secrete	v.隱秘，分泌
sect	n.宗派，教派，流派，段
sectional	a.部分的，可組合的
sector	n. 部門，部分，象限，磁區
secular	a.世俗的
securely	ad.安全地，堅固地
sediment	n.沉澱物
seedling	n. 幼苗
segment	n.節，段，片段，節肢動物的一節
seismal	a.地震的
self-sufficient	a.自給自足的
semimolten	a.半熔化的
sensibility	n. 理智
sensitive	a.敏感的
sensimental	a.多愁善感的
sequence	n.次序，順序
sequential	a.連續的，有序的
serene	a.平靜的，安詳的
serrate/serrated	a.鋸齒狀的
setting	n. 背景，環境，安裝
sewer	n. 下水道
shatter	v./n.粉碎
shear	v.修剪
shed	v.(頭髮)脫落
sheer	a. 純粹的
shelter	v./n.掩蔽處
shepherd	n.牧羊犬
shield	n.盾v.保護
shifting	 n.狡猾a.轉瞬即逝的
ship	v.運送
shipwright	n.造船工人
short-range	a. 短射程的
shriek	v. 尖叫
shrink	v. 收縮
shrub	n.灌木叢
shutter	n.百葉窗
shuttle	n.梭子，往返汽車 v.穿梭往返
signify	v. 表示，意味
silicon	n. 矽
silversmith	n.銀匠
simultaneous	a. 同時的
scepticism/skepticism	n.懷疑論
skull	n.頭顱
slab	n.厚平板
slice	n.薄片v.切片
slide	v./n.滑行
slope	n.斜坡，斜面
slowbreeding	a.養育起來很慢的
smother	v.窒息，把人悶死
smuggle	n./v.走私
snap	v. 使劈啪響，突然折斷，猛咬
snappish	a. 脾氣暴躁的
snippet	n.片段
snowflake	n.雪花
snug	a.溫暖舒適的
social distinction	n. 社會身份
solder	 n./v.焊接
solemn	a.嚴肅的，隆重的
solidarity	n.鞏固，團結
solidify	v.使凝固，使團結，鞏固
solitary	a.孤獨的
solo	a. 獨奏曲，單獨的
soluble	a.可溶解的
solution	 n.解決辦法，溶液，溶解
soothe	v.安慰，使(痛苦)減輕
sophisticate	a.詭辯的，老於事故的，設備精緻的
sophistication	n. 世故，老練；精密化
sort	n./v.種類
soybean	n.大豆
spacecraft	n.航天器，太空船(單複數相同)
spacious	a. 廣大的，大規模的
span	n./v.跨度，橫越
sparing	"a.節儉的,保守的"
spark	spark火花，閃爍
sparse	a.稀少的，稀疏的
spawn	n./v.魚卵，產卵
specialize	"v.專攻,使專用於"
species	n.物種
specification	 n.詳述(pl.)規格，說明書
specimen	n. 樣本，標本
spectacular	a. 引人入勝的，壯觀的
spectator	n.(比賽)觀眾
speculate	v.推測，思索(about)，做投機買賣(in)
sphere	"n.球,領域"
spinal	"a,脊骨的"
spiral	a.螺旋的v.盤旋
split	v./n.分裂，鬧矛盾，裂口
spoil	 v.毀壞，破壞，慣壞
sponge	n.海綿
spontaneous	a. 自發的，天生就會的
spotlight	"n, 聚光燈，強調，使醒目"
spray	n.噴霧v.噴射
sprout	v.萌芽n.苗芽
spur	n.踢馬刺v.刺激，鼓勵
squash	v.壓扁，鎮壓n.南瓜，擁擠的人群
squeeze	v./n.擠壓，壓榨
squirt	v.噴出
stabilize	 v.使穩定
stagecoach	n.公共馬車
staggering	a.令人震驚的
stagnant	a.停滯不前的，死水般的
staircase	n.樓梯
stalk	n.莖，稈v.跟蹤獵物
staple	n.釘書釘，主要產品(或商品)
starch	n.澱粉
starfish	n.海星
starvation	 n.饑餓，餓死
starve	v.挨餓
stash	v.中斷n.隱藏處
stationary	 a.穩定的，不動的
status	n.地位，身份
steep	a.陡峭的，懸崖 v.浸
steer	 v.駕駛，掌舵
stellar	a.恒星的
stem	n.莖幹，詞幹v.滋生，阻止(from)
sterile	a.無菌的，荒蕪的
sticky	a.粘的
stiffen	v.使僵硬，使粘稠
stimulus	n.刺激物，興奮劑，刺激
sting	 v./n.刺，刺痛
stitch	 v.縫n.一針，針腳
stockcar	n. 畜用車廂，比賽用汽車
stoneman	n. 石匠，石工
stout	a. 結實的，矮胖的n.矮胖子
strained	a.緊張的
strand	n.繩之一股v.船擱淺
stratum	 n.地層，社會階層
stretch	 v.延伸，擴展n.一段時間，路程
stride	v.大步走n.步幅astride橫跨著地
strike	v. 罷工，打擊
striking	a.觸目驚心的，顯著的，打擊的
string	 n.線，弦
stringent	a.嚴厲的，迫切的，銀根緊的
strip	v.剝 n.條
strive	v.努力
stroke	n.球的一擊，船的一劃，繪畫的一筆，
stylize	"a, 程式化的"
subduce	v.除去
submerge	v.淹沒
submit	v.遞交，使服從
subsequent	a.隨後的
subside	v.暴風雨平息
subsidize	 v.資助，津貼，建立子公司
subsist	v.用糧食供養
substantial	 a.實在的 ，堅固的，充實的
substantive	a.本質上的，大量的
substitute	v./n.代替
subterranean	a.地下的
subtile	 a.微妙的
subtract	v.減去
successive	 a. 繼承的，連續的
succinct	a.簡潔的，緊身的
sufficient	a.足夠的
summit	n.頂峰，最高階層a.政府首腦的
sumptuous	a.奢侈的，華麗的
superficial	a.表面的，淺薄的
superior	n.長者，上級 a.較高的，出眾的
supernature	"a, 超自然的，神奇的"
supplement	n..補充，附錄
suppress	v.壓制，鎮壓
supreme	a.極高的，崇高的
surface	n./a.表面(的)v.浮現出來，暴露
surging	n.洶湧
surpass	v.超越，勝過
sustain	v. 支援，支撐，提供食品
sustained	a.持續的，一貫的
sustenance	 n.食物，糧食必需品
swamp	n.沼澤 v.淹沒
swarm	 n.蜂群，一大群 v.湧往，雲集
sweep	v.掃，席捲
symbiotic	a.共生的
symmetrical	a.對稱的
sympathetic	a.同情的
synthetic	a.合成的，綜合的
syrup	 n.糖漿，果汁
tableland	n.高原
tariff	n.關稅
tavern	n.小酒館，客棧
tectonics	n. 構造地質學
tedium	n.冗長，沉悶
telegraph	n.電報
temple	n.廟宇，太陽穴
temporal	a.暫時的，世俗的
tenant	n.房客，v.出租
tendency	 n.傾向
tenement	n.房產，房屋的總稱
tentacle	n.(動物)觸鬚，觸角
terminal	 n.終端，終點站
terminology	 n.術語學
terrace	n.梯田，臺地，陽臺
terrain	n.地形地貌
terrane	n.岩層
terrestrial	a.地球上的，陸地的
terrene	n.地球，陸地，土質的
textile	n.紡織品
texture	n.(織品的)質地，結構
thigh	 n.大腿，股
thread	n.線，線索，思路
three-dimensional	a.三維的，立體的
thrive	v.興旺，蓬勃發展
thunder storm	n.雷雨
tilt	 v.(使)傾斜
timber	n.木料
timid	a.膽小的
tissue	n.細胞組織結構
tolerance	 n.寬容
topographical	a.地形學的
topology	n.拓撲，佈局
tornado	n.龍捲風
torpedo	n.魚雷
torque	 n.手鐲，扭矩，轉矩
torrent	 n.洪流
toxic	a.有毒的
trace	n.動物留下的蹤跡，痕跡
track	n.軌道，小路
trail	n.蹤跡，小路v.跟蹤
trample	 v./n.踐踏
tranquility	n.安靜，平靜
transcend	v.超越，超過
transcendent	 a.卓越的，超然的
transfer	v.轉移，轉學，轉帳
transform	v.改變形狀，轉化
transition	n.過渡時期
translucent	a.半透明的
transparent	a.透明的
transmit	v.發射信號，傳播
transmitter	n.轉送者，發報機，發射器
transplant	v./n.移植
trap	 n.陷阱v.設圈套，陷害
tread	n./v.踏
treason	n.叛國罪，背信
tremendous	a.巨大的
trench	n./v.溝，挖戰壕
trend	n.潮流，傾向
tribal	a.種族的
trickle	v.滴流，涓涓細流
trigger	n.扳機vt.引起，引發
tropical	a.熱帶的，熱情的
tub	n.浴盆，大桶
tube	n.軟管子
tumble	 v.翻滾n.摔跤
tundra	"n. 苔原, 凍土地帶"
tunnel	n.隧道
turbulence	n.騷亂，(氣流)紊亂
turbulent	a.混亂的，攪亂的
turnpike	n.收費公路
turquoise	n.綠松石
twine	n.麻線v.使纏繞
twist	 n./v.扭曲
typify	v.成為典型，代表
tyrannical	a.殘暴的tyrant n.暴君
ultrasonic	a. 超聲波的
unadorned	a.未裝飾的，樸素的
unbridgeable	a.不能架橋的，不能逾越的
uncharted	a. 海圖上未標明的，不詳的
undergo	v.遭受(苦難)
underlying	a.潛在的，作為基礎的，根本的
undertake	v.承擔
undoubted	a.不容置疑的，確實的
unexplored	a.未開發的，未探索的
unfertilized	a.未施肥的，未受精的
unimaginable	a.不可想像的
uninhabited	a.沒人居住的
unpalatable	a.味道差的，不好吃的
unprecedented	a. 空前的
unpredictable	a.不可預知的
unpromising	a.無希望的
unravel	v.拆開，解開
unregistered	a. 未註冊的
unsubstantiated	a.未證實的
untouched	a. 未觸動的，不受感動的
upgrade	v. (電腦)更新，升級
upland	n.丘陵地
urban	a.城市的，市內的
urbanism	n.都市生活
urbanite	n. 都市人
urbanization	n. 農村的都市化
usher	n.領座員 v.引導
utilitarian	a.功利主義的
utilization	 n.利用utilize v.利用
Utopian	a.烏托邦的，理想化的
utterly	ad.完全地
vacancy	n.空
vanish	v.消失
variable	a. 易變的，不定的
variance	n.差異，不同
varnish	n.清漆，凡立水
vault	n. 地下室，銀行地下庫
vegetation	n. 植被
veil	n. 面紗，v.掩飾
veining	n.礦脈，葉脈的排列
velocity	n.速度
venerable	a.莊嚴的，可敬的
vent	n.通風口
venture	 v/n.冒險
verse	n.詩歌的總稱
version	n.版本，譯本
vertebrate	n.脊椎動物
vertical	a.垂直的
vessel	n.船的總稱，容器
viable	a.能夠活下去的
vigilance	n.警惕，警覺
violence	n. 暴力
viral	n.濾過性毒菌的
viscosity	" n. 粘質, 粘性"
vivid	a.生動的，顏色鮮豔的
void	a.空的，無人的，無用的
volatile	a.揮發性的，脾氣反復無常的
volcanic	a.火山的
voracious	a.貪吃的 
vulnerable	a.易受攻擊的，易受外界影響的
waist	n.腰
walnut	n.胡桃
warehouse	n.倉庫
warily	ad.警惕地
waxy	a.象蠟的，蒼白的
weary	a.疲勞的，厭倦的
weather	v.風化
weird	a.怪異的
weld	v.焊接
well-being	n.社會安寧富有的狀態
well-organized	a.組織機構好的狀態
whim	n.一時的興致，反復無常
whimsical	 a.反復無常的
whittle	v.切，削
wholesale	n.批發
wholesome	a.健康的，衛生的
willow	n.柳樹
witness	n.目擊者v.親眼目睹
wrap	v.包
wrack	n.船失事，v.完全損壞
wreck	n.失事船或飛機，殘骸
wreckage	 n.失事，遭難 
yawn	v.打呵欠
yarn	n.紗線
yield	 n.糧食產量v.屈服(to)
yolk/yelk	n.蛋黃
zealous	a.熱情的
